Alarm.Date,Incident.Type,Estimated.Property.Loss,Estimated.Content.Loss,District,Zip,Property.Use,Total.loss,Fire
08-01-2020,111,100000,100000,11,2134,569,200000,1
08-01-2020,113,500,0,11,2135,400,500,1
08-01-2020,111,175000,25000,3,2111,460,200000,1
08-01-2020,111,25000,5000,8,2124,429,30000,1
08-02-2020,111,6000,0,1,2128,419,6000,1
08-02-2020,111,15000,1000,3,2108,429,16000,1
08-03-2020,131,10000,500,9,2121,960,10500,1
08-04-2020,118,0,1000,3,2110,174,1000,1
08-05-2020,151,500,0,8,2124,800,500,1
08-05-2020,113,500,1000,8,2124,419,1500,1
08-06-2020,160,2000,0,3,2114,900,2000,1
08-06-2020,111,0,15000,9,2119,429,15000,1
08-06-2020,111,15000,15000,6,2210,500,30000,1
08-06-2020,131,24000,1000,12,2136,960,25000,1
08-06-2020,111,90000,10000,7,2122,429,100000,1
08-07-2020,111,5000,0,7,2125,429,5000,1
08-07-2020,113,0,8000,1,2128,400,8000,1
08-07-2020,113,0,8000,1,2128,400,8000,1
08-08-2020,111,10000,0,1,2128,429,10000,1
08-09-2020,131,6000,1000,6,2118,963,7000,1
08-09-2020,112,5000,0,6,2127,429,5000,1
08-10-2020,151,500,1,3,2129,0,501,1
08-10-2020,111,10000,10000,6,2127,429,20000,1
08-10-2020,113,2500,2500,6,2127,429,5000,1
08-11-2020,111,150000,5000,11,2215,160,155000,1
08-11-2020,111,25000,2000,3,2129,150,27000,1
08-12-2020,131,15000,0,7,2125,962,15000,1
08/13/2020,111,3000,3000,4,2215,400,6000,1
08/13/2020,113,0,1000,8,2124,429,1000,1
08/14/2020,142,10000,0,12,2132,900,10000,1
08/15/2020,131,10000,0,1,2128,961,10000,1
08/15/2020,112,6000,500,3,2110,429,6500,1
08/16/2020,111,50000,50000,7,2124,419,100000,1
08/16/2020,111,3000,4000,11,2134,579,7000,1
08/17/2020,113,0,750,4,2118,429,750,1
08/17/2020,113,1000,0,7,2119,400,1000,1
08/18/2020,131,7000,0,8,2124,962,7000,1
08/18/2020,111,170000,30000,11,2134,429,200000,1
08/19/2020,111,8000,2000,3,2108,213,10000,1
08/19/2020,111,40000,10000,12,2136,400,50000,1
08/19/2020,113,5000,10000,9,2130,322,15000,1
08/21/2020,111,10000,0,1,2128,429,10000,1
08/22/2020,131,750,0,3,2110,961,750,1
08/23/2020,111,2000,0,7,2125,429,2000,1
08/24/2020,111,5000,0,8,2126,429,5000,1
08/24/2020,131,8000,1000,7,2118,960,9000,1
08/24/2020,112,1000,0,3,2203,160,1000,1
08/25/2020,111,500,0,11,2134,429,500,1
08/25/2020,111,3500,3500,12,2130,161,7000,1
08/25/2020,111,7500,1000,11,2134,429,8500,1
08/26/2020,113,1000,1000,12,2132,429,2000,1
08/26/2020,111,500,0,7,2121,429,500,1
08/28/2020,118,0,500,1,2128,429,500,1
08/28/2020,111,5000,0,7,2125,429,5000,1
08/30/2020,111,3000,0,3,2111,460,3000,1
08/30/2020,131,5000,0,8,2124,900,5000,1
08/30/2020,113,0,5000,4,2115,160,5000,1
08/31/2020,111,5000,0,12,2132,881,5000,1
08/31/2020,131,2000,0,9,2130,962,2000,1
08/31/2020,111,10000,5000,1,2128,429,15000,1
12-02-2020,111,1500,500,1,2128,429,2000,1
12-02-2020,111,200000,50000,4,2118,429,250000,1
12-03-2020,111,1000,1000,9,2119,400,2000,1
12-03-2020,118,0,500,4,2115,460,500,1
12-04-2020,113,1000,1000,3,2129,429,2000,1
12-04-2020,113,1000,1000,11,2135,429,2000,1
12-05-2020,160,5000,0,7,2125,962,5000,1
12-05-2020,111,0,500,8,2124,429,500,1
12-06-2020,111,10000,15000,7,2124,419,25000,1
12-08-2020,111,30000,0,6,2210,429,30000,1
12-09-2020,111,150000,0,7,2119,429,150000,1
12-10-2020,111,15000,0,6,2127,419,15000,1
12-10-2020,113,0,1000,1,2128,429,1000,1
12-11-2020,111,0,2000,3,2108,162,2000,1
12-11-2020,111,250,2500,9,2120,429,2750,1
12-11-2020,111,20000,5000,12,2131,419,25000,1
12-12-2020,131,5000,0,12,2136,960,5000,1
12/14/2020,131,6000,1000,7,2122,962,7000,1
12/14/2020,111,50000,5000,8,2126,429,55000,1
12/14/2020,111,175000,75000,4,2215,400,250000,1
12/15/2020,113,3000,4000,11,2135,400,7000,1
12/15/2020,131,25000,0,8,2126,962,25000,1
12/15/2020,113,2000,2000,11,2135,429,4000,1
12/16/2020,111,150000,50000,9,2130,419,200000,1
12/16/2020,161,5000,0,7,2121,900,5000,1
12/16/2020,161,1000,0,7,2121,900,1000,1
12/18/2020,111,250000,250000,8,2122,519,500000,1
12/19/2020,111,1000,0,8,2124,429,1000,1
12/20/2020,113,500,0,12,2131,419,500,1
12/21/2020,113,4000,2000,9,2120,429,6000,1
12/21/2020,113,250,250,9,2130,429,500,1
12/22/2020,111,50000,10000,1,2128,429,60000,1
12/22/2020,111,40000,10000,8,2126,429,50000,1
12/22/2020,113,1000,0,8,2126,429,1000,1
12/22/2020,111,18000,32000,12,2136,429,50000,1
12/23/2020,131,2000,1000,4,2118,0,3000,1
12/24/2020,118,1000,1000,7,2125,429,2000,1
12/24/2020,113,0,500,8,2124,429,500,1
12/24/2020,118,1000,1000,1,2128,429,2000,1
12/25/2020,150,1000,0,8,2124,429,1000,1
12/26/2020,111,200000,150000,9,2130,419,350000,1
12/26/2020,111,10000,1000,12,2132,419,11000,1
12/27/2020,113,0,500,6,2210,429,500,1
12/27/2020,118,300,300,12,2136,429,600,1
12/28/2020,111,15000,5000,8,2124,429,20000,1
12/28/2020,111,300000,50000,11,2134,429,350000,1
12/29/2020,111,125000,25000,8,2126,419,150000,1
12/29/2020,111,0,50000,7,2122,429,50000,1
12/30/2020,118,3000,0,3,2114,400,3000,1
12/31/2020,131,75000,1000,9,2119,963,76000,1
12/31/2020,112,10000,0,3,2129,0,10000,1
12/31/2020,113,1000,1000,12,2131,429,2000,1
12/31/2020,113,1000,1000,12,2132,419,2000,1
12/31/2020,131,10000,2000,7,2124,900,12000,1
12/31/2020,111,2000,1000,11,2134,400,3000,1
07-01-2020,131,2000,11000,3,2111,599,13000,1
07-01-2020,131,1000,0,3,2111,599,1000,1
07-02-2020,113,5000,5000,7,2125,400,10000,1
07-02-2020,111,2000,2000,6,2127,429,4000,1
07-02-2020,111,5000,1000,9,2120,429,6000,1
07-03-2020,111,300000,50000,8,2126,429,350000,1
07-03-2020,111,5000,0,7,2124,429,5000,1
07-03-2020,113,10000,5000,4,2115,439,15000,1
07-03-2020,111,30000,20000,3,2129,459,50000,1
07-04-2020,131,40000,0,7,2119,960,40000,1
07-04-2020,131,30000,300,8,2124,962,30300,1
07-04-2020,113,0,500,6,2127,429,500,1
07-05-2020,131,6000,1000,7,2121,962,7000,1
07-05-2020,111,0,500,9,2130,419,500,1
07-09-2020,131,5000,0,12,2131,962,5000,1
07-09-2020,112,5000,1000,7,2121,429,6000,1
07-11-2020,113,0,1000,3,2113,429,1000,1
07-11-2020,111,20000,0,7,2125,429,20000,1
07-11-2020,160,500,0,7,2122,900,500,1
07/14/2020,111,0,1000,7,2125,460,1000,1
07/15/2020,113,500,0,9,2119,429,500,1
07/15/2020,113,0,500,12,2136,519,500,1
07/16/2020,131,8000,0,8,2126,962,8000,1
07/17/2020,113,1000,1000,6,2127,400,2000,1
07/17/2020,131,7000,0,9,2119,960,7000,1
07/18/2020,131,4000,0,12,2132,900,4000,1
07/19/2020,442,0,5000,6,2210,449,5000,1
07/19/2020,111,1000,0,7,2125,429,1000,1
07/19/2020,111,85000,15000,8,2124,419,100000,1
07/20/2020,112,0,500,12,2131,419,500,1
07/21/2020,131,10000,0,9,2121,962,10000,1
07/21/2020,111,1000,1000,6,2127,429,2000,1
07/21/2020,111,1000,0,7,2121,429,1000,1
07/22/2020,111,20000,0,11,2134,429,20000,1
07/22/2020,131,500,0,1,2128,965,500,1
07/23/2020,131,10000,1000,4,2118,965,11000,1
07/23/2020,111,50000,5000,6,2127,429,55000,1
07/25/2020,154,1000,1000,11,2134,965,2000,1
07/26/2020,111,30000,0,11,2135,429,30000,1
07/26/2020,131,5000,0,8,2122,965,5000,1
07/26/2020,131,5000,200,8,2124,960,5200,1
07/27/2020,131,5000,1000,9,2121,963,6000,1
07/27/2020,111,1000,1000,9,2121,429,2000,1
07/27/2020,131,5000,2000,4,2118,960,7000,1
07/28/2020,111,500000,20000,8,2124,429,520000,1
07/28/2020,111,65000,10000,1,2128,429,75000,1
07/29/2020,111,2000,1000,9,2130,429,3000,1
07/29/2020,111,5000,2000,8,2124,564,7000,1
07/30/2020,111,200000,5000,11,2135,429,205000,1
07/30/2020,111,80000,20000,8,2124,429,100000,1
07/30/2020,111,5000,0,7,2119,429,5000,1
07/31/2020,111,500,0,7,2121,419,500,1
07/31/2020,111,0,10000,4,2118,400,10000,1
07/31/2020,131,10000,1000,8,2124,960,11000,1
11-02-2020,111,0,2000,7,2124,429,2000,1
11-04-2020,113,0,500,4,2118,511,500,1
11-04-2020,111,20000,0,8,2126,429,20000,1
11-05-2020,111,300000,200000,8,2124,519,500000,1
11-05-2020,111,25000,15000,4,2215,429,40000,1
11-05-2020,112,500,0,1,2128,0,500,1
11-05-2020,113,2000,1000,12,2132,429,3000,1
11-07-2020,111,3000,1000,3,2113,429,4000,1
11-07-2020,118,500,100,9,2130,400,600,1
11-08-2020,111,100000,0,7,2119,891,100000,1
11-08-2020,113,1000,0,1,2128,429,1000,1
11-08-2020,111,1000,500,11,2135,400,1500,1
11-08-2020,111,250000,50000,7,2119,429,300000,1
11-10-2020,112,0,5000,12,2130,881,5000,1
11-10-2020,111,1000,0,4,2118,429,1000,1
11-10-2020,111,8000,2000,4,2111,439,10000,1
11-10-2020,111,30000,30000,12,2136,400,60000,1
11-11-2020,131,4000,2000,4,2118,960,6000,1
11-11-2020,112,2000,500,12,2132,549,2500,1
11-11-2020,131,1000,0,8,2124,962,1000,1
11-12-2020,111,50000,20000,11,2134,429,70000,1
11-12-2020,111,500,2000,9,2115,460,2500,1
11/13/2020,131,10000,1000,8,2124,962,11000,1
11/13/2020,131,4000,1000,8,2124,960,5000,1
11/13/2020,111,1000,100,1,2128,460,1100,1
11/13/2020,131,12000,500,11,2135,965,12500,1
11/13/2020,112,0,500,7,2124,429,500,1
11/15/2020,131,8000,0,7,2125,962,8000,1
11/15/2020,113,2000,0,9,2467,519,2000,1
11/15/2020,111,1000,0,11,2135,564,1000,1
11/17/2020,111,15000,5000,1,2128,429,20000,1
11/18/2020,113,100,400,3,2109,400,500,1
11/18/2020,111,1000,1000,6,2127,500,2000,1
11/19/2020,111,9000,0,7,2119,429,9000,1
11/19/2020,111,5000,0,4,2118,439,5000,1
11/20/2020,111,900000,0,7,2122,429,900000,1
11/20/2020,111,50000,0,7,2122,429,50000,1
11/20/2020,111,50000,25000,9,2119,429,75000,1
11/20/2020,111,500,100,1,2128,429,600,1
11/20/2020,131,8000,1000,8,2124,963,9000,1
11/21/2020,111,750000,60000,8,2124,429,810000,1
11/21/2020,111,750000,30000,8,2124,429,780000,1
11/21/2020,131,2000,2000,6,2127,962,4000,1
11/21/2020,162,500,0,11,2135,429,500,1
11/22/2020,111,125000,75000,11,2134,400,200000,1
11/23/2020,162,1000,1000,6,2210,449,2000,1
11/25/2020,162,2000,0,9,2215,331,2000,1
11/25/2020,111,3000,2000,9,2130,429,5000,1
11/25/2020,111,25000,5000,6,2118,888,30000,1
11/27/2020,111,15000,0,8,2124,400,15000,1
11/28/2020,113,0,500,12,2130,419,500,1
10-01-2020,111,300000,50000,8,2124,429,350000,1
10-01-2020,111,0,1000,7,2118,429,1000,1
10-02-2020,111,600000,15000,7,2125,429,615000,1
10-02-2020,112,20000,0,7,2125,429,20000,1
10-02-2020,111,20000,0,7,2125,429,20000,1
10-03-2020,442,0,600,4,2118,419,600,1
10-04-2020,131,4000,200,8,2126,965,4200,1
10-04-2020,131,10000,0,8,2126,965,10000,1
10-04-2020,131,6000,0,8,2126,965,6000,1
10-05-2020,131,15000,0,12,2132,900,15000,1
10-05-2020,131,10000,0,8,2124,900,10000,1
10-08-2020,131,10000,1000,3,2109,922,11000,1
10-08-2020,113,0,500,6,2127,429,500,1
10-09-2020,113,1000,0,3,2111,400,1000,1
10-09-2020,140,500,500,6,2210,926,1000,1
10-11-2020,132,50000,4000,11,2134,961,54000,1
10-11-2020,111,65000,10000,7,2119,429,75000,1
10-12-2020,111,3000,250,9,2120,429,3250,1
10-12-2020,111,20000,20000,7,2125,419,40000,1
10-12-2020,111,5000,2000,11,2134,500,7000,1
10-12-2020,113,2000,2000,11,2135,400,4000,1
10-12-2020,113,1000,0,6,2125,429,1000,1
10-12-2020,131,1000,0,8,2124,900,1000,1
10/13/2020,131,5000,1000,6,2125,961,6000,1
10/13/2020,111,2000,0,9,2121,429,2000,1
10/14/2020,111,1500,1000,9,2121,131,2500,1
10/14/2020,131,3000,100,12,2136,962,3100,1
10/15/2020,111,12000,10000,7,2125,429,22000,1
10/15/2020,113,1000,1000,7,2119,419,2000,1
10/16/2020,113,0,500,4,2118,429,500,1
10/16/2020,113,0,500,4,2118,429,500,1
10/17/2020,113,300,300,4,2116,400,600,1
10/18/2020,111,1000,1000,12,2136,419,2000,1
10/20/2020,131,5000,0,6,2127,900,5000,1
10/20/2020,131,5000,0,6,2127,900,5000,1
10/20/2020,131,5000,0,6,2127,900,5000,1
10/20/2020,131,50000,0,6,2127,960,50000,1
10/21/2020,480,1000,1000,4,2215,900,2000,1
10/21/2020,131,4000,0,7,2122,963,4000,1
10/22/2020,131,40000,5000,7,2121,962,45000,1
10/22/2020,131,5000,0,4,2116,963,5000,1
10/23/2020,131,40000,0,1,2128,579,40000,1
10/24/2020,111,8000,2000,8,2124,419,10000,1
10/24/2020,111,15000,5000,1,2128,800,20000,1
10/25/2020,131,20000,3000,7,2125,962,23000,1
10/26/2020,111,8000,2500,12,2132,429,10500,1
10/27/2020,111,10000,0,9,2119,419,10000,1
10/28/2020,131,3000,1000,7,2122,962,4000,1
10/28/2020,131,5000,100,9,2121,962,5100,1
10/30/2020,130,25000,0,12,2131,900,25000,1
10/31/2020,118,5000,0,3,2114,174,5000,1
09-01-2020,111,10000,0,3,2114,400,10000,1
09-02-2020,113,0,1000,1,2128,429,1000,1
09-04-2020,113,1000,1000,12,2131,419,2000,1
09-05-2020,113,0,500,9,2121,429,500,1
09-05-2020,111,50000,5000,8,2122,429,55000,1
09-05-2020,113,1000,1000,12,2132,419,2000,1
09-05-2020,113,1000,1000,12,2132,500,2000,1
09-06-2020,111,100000,50000,8,2124,419,150000,1
09-06-2020,113,5000,1000,3,2114,429,6000,1
09-06-2020,111,22000,3000,9,2130,429,25000,1
09-07-2020,131,5000,100,1,2128,922,5100,1
09-08-2020,111,5000,0,7,2125,429,5000,1
09-08-2020,111,1500,500,8,2124,419,2000,1
09-08-2020,113,1000,500,7,2121,429,1500,1
09-08-2020,111,75000,0,7,2125,419,75000,1
09-09-2020,131,3000,0,7,2121,963,3000,1
09-10-2020,111,500,0,7,2125,419,500,1
09-10-2020,113,4000,3000,11,2135,400,7000,1
09-11-2020,154,500,0,9,2121,429,500,1
09-12-2020,130,3000,3000,6,2125,882,6000,1
09/13/2020,111,3000,2000,12,2136,419,5000,1
09/13/2020,111,500,500,9,2131,419,1000,1
09/13/2020,553,3000,3000,9,2115,429,6000,1
09/13/2020,113,3000,2000,11,2134,400,5000,1
09/14/2020,151,0,500,4,2116,900,500,1
09/15/2020,113,500,0,8,2124,429,500,1
09/15/2020,113,0,1000,11,2135,429,1000,1
09/15/2020,113,0,1000,11,2134,429,1000,1
09/15/2020,111,0,2000,9,2119,419,2000,1
09/16/2020,116,0,500,3,2114,429,500,1
09/16/2020,111,8000,2500,12,2136,429,10500,1
09/16/2020,111,6000,0,4,2215,429,6000,1
09/16/2020,113,2500,2500,11,2134,429,5000,1
09/16/2020,111,500,0,7,2125,429,500,1
09/17/2020,111,5000,0,8,2124,419,5000,1
09/18/2020,111,300000,50000,8,2124,429,350000,1
09/18/2020,111,50000,25000,8,2124,429,75000,1
09/18/2020,111,20000,0,8,2124,429,20000,1
09/18/2020,111,30000,0,8,2124,429,30000,1
09/18/2020,111,10000,0,8,2124,429,10000,1
09/18/2020,131,10000,0,8,2124,965,10000,1
09/18/2020,131,10000,0,8,2124,965,10000,1
09/18/2020,113,1000,1000,12,2132,419,2000,1
09/18/2020,111,10000,0,11,2134,500,10000,1
09/18/2020,111,0,2000,6,2127,419,2000,1
09/19/2020,142,250,250,9,2119,962,500,1
09/19/2020,160,15000,0,12,2131,900,15000,1
09/19/2020,131,5000,1000,8,2124,900,6000,1
09/20/2020,162,0,5000,4,2215,981,5000,1
09/20/2020,131,6000,0,7,2122,963,6000,1
09/20/2020,113,4000,1000,9,2119,429,5000,1
09/21/2020,111,190000,10000,7,2124,429,200000,1
09/21/2020,111,50000,0,8,2124,419,50000,1
09/21/2020,111,10000,15000,9,2120,429,25000,1
09/22/2020,151,500,0,7,2125,900,500,1
09/22/2020,111,20000,5000,12,2136,429,25000,1
09/22/2020,111,2000,1500,1,2128,429,3500,1
09/23/2020,131,5000,1000,12,2131,960,6000,1
09/24/2020,111,40000,10000,9,2121,429,50000,1
09/24/2020,131,20000,5000,7,2127,900,25000,1
09/24/2020,111,25000,75000,9,2119,419,100000,1
09/25/2020,131,10000,300,9,2121,965,10300,1
09/25/2020,111,500000,0,7,2125,429,500000,1
09/25/2020,113,250,250,9,2121,429,500,1
09/26/2020,111,3000,2000,11,2134,429,5000,1
09/26/2020,111,175000,25000,8,2124,429,200000,1
09/26/2020,111,2500,2500,11,2135,429,5000,1
09/30/2020,142,1000,1000,11,2135,960,2000,1
09/30/2020,162,1000,1000,11,2134,960,2000,1
09/30/2020,111,750000,50000,3,2111,429,800000,1
10-08-2020,700,0,0,6,2127,400,0,0
12/20/2020,553,0,0,7,2122,429,0,0
07/25/2020,511,0,0,6,2110,900,0,0
11-01-2020,743,0,0,4,2116,400,0,0
07-09-2020,715,0,0,9,2119,400,0,0
07/16/2020,113,0,0,9,2119,400,0,0
11/14/2020,714,0,0,9,2121,429,0,0
12-04-2020,715,0,0,7,2122,429,0,0
10-09-2020,500,0,0,12,2136,419,0,0
09/25/2020,411,0,0,4,2118,962,0,0
09/25/2020,511,0,0,3,2113,900,0,0
08-07-2020,641,0,0,9,2130,962,0,0
11/16/2020,714,0,0,6,2125,500,0,0
09-05-2020,500,0,0,3,2110,900,0,0
07-05-2020,745,0,0,6,2127,519,0,0
11-03-2020,743,0,0,4,2215,400,0,0
09/15/2020,553,0,0,7,2119,400,0,0
11/23/2020,113,0,0,8,2126,429,0,0
12/18/2020,445,0,0,9,2115,900,0,0
07/24/2020,554,0,0,6,2127,429,0,0
10-06-2020,745,0,0,6,2127,429,0,0
08/14/2020,553,0,0,1,2128,151,0,0
07/28/2020,553,0,0,7,2119,960,0,0
09/21/2020,736,0,0,6,2127,429,0,0
10-07-2020,553,0,0,8,2126,419,0,0
09-10-2020,714,0,0,3,2111,429,0,0
11/30/2020,621,0,0,12,2131,429,0,0
07-04-2020,743,0,0,7,2125,429,0,0
10/21/2020,714,0,0,7,2122,429,0,0
08/29/2020,622,0,0,4,2116,961,0,0
08-01-2020,113,0,0,11,2135,400,0,0
09-02-2020,553,0,0,9,2121,429,0,0
09/24/2020,743,0,0,7,2119,400,0,0
12-09-2020,611,0,0,3,2108,951,0,0
10-07-2020,553,0,0,8,2124,962,0,0
12-12-2020,413,0,0,1,2128,400,0,0
07-11-2020,552,0,0,8,2124,900,0,0
12/18/2020,600,0,0,3,2114,331,0,0
09-08-2020,733,0,0,12,2132,419,0,0
07/31/2020,552,0,0,3,2113,963,0,0
11/17/2020,553,0,0,9,2215,500,0,0
09-06-2020,743,0,0,7,2125,429,0,0
11/30/2020,600,0,0,8,2124,900,0,0
12-09-2020,441,0,0,8,2126,429,0,0
10/26/2020,714,0,0,7,2125,439,0,0
07/28/2020,553,0,0,7,2125,429,0,0
08-05-2020,735,0,0,4,2118,429,0,0
11/22/2020,511,0,0,8,2124,900,0,0
11-07-2020,553,0,0,3,2113,429,0,0
12/29/2020,113,0,0,4,2215,400,0,0
08/20/2020,745,0,0,7,2125,429,0,0
10-01-2020,500,0,0,4,2116,429,0,0
09-05-2020,553,0,0,4,2115,400,0,0
08-08-2020,743,0,0,12,2132,331,0,0
10-10-2020,142,0,0,11,2134,963,0,0
09/23/2020,553,0,0,12,2136,419,0,0
08-08-2020,715,0,0,12,2136,429,0,0
08/26/2020,554,0,0,4,2116,429,0,0
09/25/2020,735,0,0,12,2136,419,0,0
09/18/2020,711,0,0,8,2124,429,0,0
07-12-2020,113,0,0,7,2122,429,0,0
07-07-2020,743,0,0,7,2122,429,0,0
09-11-2020,413,0,0,1,2128,922,0,0
12-12-2020,652,0,0,12,2131,962,0,0
10/16/2020,522,0,0,8,2124,419,0,0
11-07-2020,511,0,0,11,2135,900,0,0
10/20/2020,745,0,0,4,2118,429,0,0
08-11-2020,621,0,0,3,2114,900,0,0
09-04-2020,745,0,0,8,2126,429,0,0
11/18/2020,735,0,0,12,2131,419,0,0
08/22/2020,552,0,0,6,2119,900,0,0
09/22/2020,744,0,0,9,2130,400,0,0
09/18/2020,652,0,0,4,2215,439,0,0
10/25/2020,551,0,0,12,2132,400,0,0
07-06-2020,700,0,0,4,2118,981,0,0
08/22/2020,151,0,0,6,2118,963,0,0
12/26/2020,743,0,0,7,2125,429,0,0
08/22/2020,733,0,0,3,2111,429,0,0
07-06-2020,735,0,0,6,2127,400,0,0
09/24/2020,113,0,0,4,2116,400,0,0
08-04-2020,813,0,0,12,2132,419,0,0
12-08-2020,745,0,0,8,2126,429,0,0
09/13/2020,553,0,0,9,2130,960,0,0
11-04-2020,551,0,0,1,2128,429,0,0
11/22/2020,113,0,0,3,2109,429,0,0
10/27/2020,714,0,0,4,2116,460,0,0
09-04-2020,553,0,0,6,2118,961,0,0
12-06-2020,113,0,0,11,2163,460,0,0
08/28/2020,522,0,0,11,2135,429,0,0
09/29/2020,600,0,0,7,2122,429,0,0
09/13/2020,113,0,0,1,2128,429,0,0
08-05-2020,553,0,0,8,2126,419,0,0
09/30/2020,651,0,0,7,2122,429,0,0
12/19/2020,550,0,0,7,2119,960,0,0
08/19/2020,715,0,0,8,2124,429,0,0
07-06-2020,746,0,0,7,2119,419,0,0
09-01-2020,600,0,0,4,2116,429,0,0
12-04-2020,711,0,0,9,2119,960,0,0
10/21/2020,553,0,0,8,2124,429,0,0
09/27/2020,710,0,0,11,2135,400,0,0
08-03-2020,743,0,0,6,2127,400,0,0
07/29/2020,733,0,0,9,2130,429,0,0
09-07-2020,150,0,0,9,2119,900,0,0
08-09-2020,600,0,0,4,2116,962,0,0
10-11-2020,700,0,0,3,2113,429,0,0
09-08-2020,413,0,0,12,2136,962,0,0
07/24/2020,714,0,0,3,2129,500,0,0
12/21/2020,553,0,0,4,2118,215,0,0
10/29/2020,600,0,0,8,2122,419,0,0
09/25/2020,113,0,0,11,2135,419,0,0
09/29/2020,554,0,0,11,2135,400,0,0
09-07-2020,553,0,0,12,2136,429,0,0
10/29/2020,743,0,0,9,2130,464,0,0
09/13/2020,113,0,0,4,2116,419,0,0
11-05-2020,553,0,0,8,2126,459,0,0
11/30/2020,553,0,0,6,2125,960,0,0
07/26/2020,714,0,0,7,2121,429,0,0
12/28/2020,651,0,0,6,2127,429,0,0
07/15/2020,745,0,0,8,2126,400,0,0
09/14/2020,745,0,0,9,2115,200,0,0
12/26/2020,553,0,0,4,2118,429,0,0
12/22/2020,743,0,0,1,2128,429,0,0
10/16/2020,745,0,0,11,2135,419,0,0
10/29/2020,553,0,0,1,2128,459,0,0
07/26/2020,733,0,0,7,2119,429,0,0
08/15/2020,553,0,0,8,2124,429,0,0
12/21/2020,745,0,0,11,2134,500,0,0
07-03-2020,500,0,0,11,2135,900,0,0
11-10-2020,744,0,0,6,2210,599,0,0
09/20/2020,735,0,0,12,2132,331,0,0
08-07-2020,413,0,0,9,2130,962,0,0
08-07-2020,412,0,0,7,2121,419,0,0
09-10-2020,745,0,0,8,2124,429,0,0
12-01-2020,553,0,0,4,2118,888,0,0
10-06-2020,740,0,0,4,2118,400,0,0
07-02-2020,553,0,0,3,2111,400,0,0
11/17/2020,113,0,0,8,2122,429,0,0
08-04-2020,113,0,0,11,2134,429,0,0
08/31/2020,714,0,0,3,2108,400,0,0
10/24/2020,553,0,0,7,2119,900,0,0
11/16/2020,600,0,0,11,2135,900,0,0
08-06-2020,715,0,0,9,2130,429,0,0
10-12-2020,745,0,0,3,2111,599,0,0
09-11-2020,735,0,0,6,2127,429,0,0
12-03-2020,711,0,0,12,2131,962,0,0
08/13/2020,743,0,0,4,2116,500,0,0
12/20/2020,511,0,0,8,2124,439,0,0
09/29/2020,600,0,0,4,2118,400,0,0
08-02-2020,553,0,0,8,2126,900,0,0
11/19/2020,553,0,0,3,2129,963,0,0
11/23/2020,600,0,0,4,2215,429,0,0
08/19/2020,714,0,0,4,2215,429,0,0
08/25/2020,741,0,0,3,2114,882,0,0
09/17/2020,735,0,0,6,2127,519,0,0
10-12-2020,113,100,100,1,2128,439,200,0
08-11-2020,522,0,0,8,2124,960,0,0
09/19/2020,113,0,0,4,2116,460,0,0
12/28/2020,113,0,0,4,2118,400,0,0
07-05-2020,500,0,0,12,2132,311,0,0
09/29/2020,553,0,0,12,2136,511,0,0
07-06-2020,745,0,0,9,2120,429,0,0
07/27/2020,553,0,0,6,2127,439,0,0
12-11-2020,553,0,0,9,2119,960,0,0
09-07-2020,714,0,0,8,2124,429,0,0
09/27/2020,743,0,0,7,2125,429,0,0
10-12-2020,745,0,0,3,2110,599,0,0
09-11-2020,611,0,0,6,2118,900,0,0
09/16/2020,551,0,0,3,2110,963,0,0
12-06-2020,553,0,0,9,2130,962,0,0
09-08-2020,522,0,0,11,2134,429,0,0
07-02-2020,745,0,0,4,2215,162,0,0
09/15/2020,600,0,0,6,2118,963,0,0
12-05-2020,553,0,0,4,2118,429,0,0
07-11-2020,553,0,0,9,2119,173,0,0
09-03-2020,553,0,0,7,2124,419,0,0
11/19/2020,714,0,0,9,2130,519,0,0
07/31/2020,553,0,0,12,2132,419,0,0
10-03-2020,743,0,0,7,2125,900,0,0
07/19/2020,744,0,0,4,2118,429,0,0
11/18/2020,553,0,0,9,2121,963,0,0
08-04-2020,553,0,0,7,2118,960,0,0
12/16/2020,736,0,0,4,2116,429,0,0
10/18/2020,113,0,0,8,2124,429,0,0
08/20/2020,714,0,0,8,2126,400,0,0
07-11-2020,553,0,0,8,2126,963,0,0
12/25/2020,400,0,0,8,2126,429,0,0
07/31/2020,733,0,0,3,2111,599,0,0
09/21/2020,553,0,0,4,2215,400,0,0
11-09-2020,745,0,0,8,2124,429,0,0
11-10-2020,745,0,0,4,2116,174,0,0
10/30/2020,553,0,0,4,2115,900,0,0
09-05-2020,740,0,0,6,2127,429,0,0
08/18/2020,733,0,0,8,2124,419,0,0
12/26/2020,151,1,1,12,2130,419,2,0
08-03-2020,745,0,0,4,2116,429,0,0
11/24/2020,735,0,0,9,2119,400,0,0
09/30/2020,522,0,0,6,2127,400,0,0
10-07-2020,551,0,0,6,2127,963,0,0
08-01-2020,733,0,0,4,2115,429,0,0
11/27/2020,745,0,0,3,2109,549,0,0
10/14/2020,735,0,0,7,2122,160,0,0
07-10-2020,553,0,0,4,2116,400,0,0
12-01-2020,113,0,0,7,2121,400,0,0
09/25/2020,151,0,0,4,2215,900,0,0
10/31/2020,552,0,0,4,2118,963,0,0
07/13/2020,743,0,0,8,2126,419,0,0
07/13/2020,743,0,0,11,2135,429,0,0
12-10-2020,554,0,0,3,2114,400,0,0
08/17/2020,553,0,0,1,2128,161,0,0
07-07-2020,113,0,0,4,2116,449,0,0
11-01-2020,552,0,0,7,2119,963,0,0
10/24/2020,714,0,0,9,2119,429,0,0
07/18/2020,600,0,0,12,2132,900,0,0
08/29/2020,733,0,0,9,2121,429,0,0
10-08-2020,700,0,0,8,2122,111,0,0
09/27/2020,745,0,0,12,2136,429,0,0
07-04-2020,553,0,0,11,2135,965,0,0
10-09-2020,733,0,0,11,2135,419,0,0
08/18/2020,553,0,0,4,2118,960,0,0
08/23/2020,714,0,0,7,2125,400,0,0
12/23/2020,714,0,0,8,2126,429,0,0
11/26/2020,113,0,0,7,2125,400,0,0
12-12-2020,746,0,0,11,2135,400,0,0
08/13/2020,735,0,0,8,2124,210,0,0
12-11-2020,600,0,0,6,2127,400,0,0
07-07-2020,553,0,0,6,2118,322,0,0
12/22/2020,714,0,0,9,2119,449,0,0
10-05-2020,113,0,0,4,2115,429,0,0
08-09-2020,600,0,0,4,2118,960,0,0
09-10-2020,745,0,0,4,2115,400,0,0
12-10-2020,511,0,0,12,2132,960,0,0
10-11-2020,151,0,0,1,2128,900,0,0
07/13/2020,743,0,0,11,2135,419,0,0
07-12-2020,611,0,0,4,2111,963,0,0
12-04-2020,900,0,0,7,2122,429,0,0
08/22/2020,553,0,0,9,2130,400,0,0
07/24/2020,553,0,0,11,2134,500,0,0
07-06-2020,553,0,0,3,2114,429,0,0
12-02-2020,554,0,0,9,2119,429,0,0
11-03-2020,500,0,0,4,2118,900,0,0
07/27/2020,746,0,0,7,2125,400,0,0
09/13/2020,553,0,0,1,2128,960,0,0
07/23/2020,743,0,0,1,2128,429,0,0
07/26/2020,743,0,0,6,2125,882,0,0
09-03-2020,510,0,0,7,2125,400,0,0
10/22/2020,736,0,0,11,2135,400,0,0
07-08-2020,621,0,0,7,2122,900,0,0
07-03-2020,151,0,0,12,2136,900,0,0
10/31/2020,553,0,0,4,2115,429,0,0
10/29/2020,736,0,0,6,2127,429,0,0
09-10-2020,622,0,0,1,2128,900,0,0
11-02-2020,552,0,0,8,2126,500,0,0
12-02-2020,413,0,0,12,2131,960,0,0
12/26/2020,551,0,0,4,2115,429,0,0
10/30/2020,210,0,0,9,2130,400,0,0
07-09-2020,745,0,0,3,2210,592,0,0
12/31/2020,745,0,0,11,2135,131,0,0
10-07-2020,553,0,0,4,2118,960,0,0
09-11-2020,651,0,0,11,2215,460,0,0
12-05-2020,600,0,0,12,2131,962,0,0
07-08-2020,553,0,0,6,2127,960,0,0
08-06-2020,553,0,0,4,2215,429,0,0
09/23/2020,745,0,0,9,2121,429,0,0
08/30/2020,712,0,0,9,2130,331,0,0
07/27/2020,745,0,0,7,2121,460,0,0
12-09-2020,740,0,0,3,2109,400,0,0
07-12-2020,553,0,0,6,2127,900,0,0
10/14/2020,554,0,0,6,2125,519,0,0
09-12-2020,554,0,0,11,2135,400,0,0
11/23/2020,714,0,0,8,2126,400,0,0
11-07-2020,553,0,0,11,2135,131,0,0
07/13/2020,552,0,0,6,2118,900,0,0
12-08-2020,745,0,0,4,2118,400,0,0
08/25/2020,745,0,0,8,2122,900,0,0
10-05-2020,711,0,0,4,2118,963,0,0
09/25/2020,522,0,0,8,2126,419,0,0
12/29/2020,743,0,0,4,2215,429,0,0
12-04-2020,745,0,0,9,2130,429,0,0
11-04-2020,622,0,0,4,2118,963,0,0
10/31/2020,714,0,0,4,2116,429,0,0
11-08-2020,651,0,0,9,2115,400,0,0
07-03-2020,714,0,0,11,2135,429,0,0
11/30/2020,553,0,0,6,2127,900,0,0
08/21/2020,740,0,0,4,2215,400,0,0
11-05-2020,551,0,0,4,2116,449,0,0
10/27/2020,551,0,0,8,2124,429,0,0
08-10-2020,424,0,0,9,2130,400,0,0
11/30/2020,600,0,0,4,2118,439,0,0
11/17/2020,745,0,0,4,2116,519,0,0
09/13/2020,553,0,0,9,2120,429,0,0
09/26/2020,553,0,0,3,2108,963,0,0
08-09-2020,736,0,0,12,2132,419,0,0
12/23/2020,743,0,0,9,2120,311,0,0
09-09-2020,715,0,0,6,2210,519,0,0
12/27/2020,413,0,0,9,2120,963,0,0
07/31/2020,552,0,0,12,2136,962,0,0
12-10-2020,714,0,0,4,2199,429,0,0
10-05-2020,745,0,0,12,2132,331,0,0
07/16/2020,500,0,0,11,2135,900,0,0
11-10-2020,553,0,0,4,2118,900,0,0
10/19/2020,743,0,0,6,2127,400,0,0
07-11-2020,611,0,0,7,2119,900,0,0
12/19/2020,553,0,0,6,2118,300,0,0
08-11-2020,714,0,0,12,2132,429,0,0
11-09-2020,745,0,0,6,2127,429,0,0
10-02-2020,743,0,0,4,2115,429,0,0
07/14/2020,554,0,0,8,2124,900,0,0
09/26/2020,735,0,0,4,2116,429,0,0
10/26/2020,500,0,0,4,2118,888,0,0
07/18/2020,553,0,0,7,2124,429,0,0
11/18/2020,552,0,0,4,2115,174,0,0
12-03-2020,730,0,0,8,2124,429,0,0
12/17/2020,742,0,0,6,2127,429,0,0
08/31/2020,900,0,0,9,2130,311,0,0
12/31/2020,113,0,0,4,2118,400,0,0
08/25/2020,746,0,0,12,2132,419,0,0
07/30/2020,735,0,0,9,2130,429,0,0
08/31/2020,712,0,0,3,2203,952,0,0
12/21/2020,735,0,0,11,2135,400,0,0
07-04-2020,553,0,0,8,2122,962,0,0
10/14/2020,554,0,0,12,2131,400,0,0
09/20/2020,411,0,0,11,2134,965,0,0
12-09-2020,551,0,0,11,2135,429,0,0
09-01-2020,553,0,0,12,2131,419,0,0
07-05-2020,600,0,0,8,2122,938,0,0
07-03-2020,744,0,0,3,2108,100,0,0
07/17/2020,743,0,0,11,2135,429,0,0
10-04-2020,733,0,0,12,2130,429,0,0
09/30/2020,743,0,0,7,2125,429,0,0
08-09-2020,150,0,0,4,2118,960,0,0
12/13/2020,113,0,0,12,2136,419,0,0
12-11-2020,553,0,0,1,2128,900,0,0
11/30/2020,700,0,0,8,2124,174,0,0
12/31/2020,553,0,0,4,2118,419,0,0
07/28/2020,745,0,0,3,2129,800,0,0
09-03-2020,600,0,0,8,2122,900,0,0
11-12-2020,745,0,0,9,2120,460,0,0
10/13/2020,552,0,0,12,2131,419,0,0
09/19/2020,745,0,0,3,2113,400,0,0
11-05-2020,424,0,0,7,2119,400,0,0
12-12-2020,745,0,0,3,2114,429,0,0
11-07-2020,711,0,0,11,2135,962,0,0
12/26/2020,553,0,0,6,2118,323,0,0
12/30/2020,553,0,0,12,2136,419,0,0
12-01-2020,733,0,0,8,2124,400,0,0
11-11-2020,611,0,0,3,2113,900,0,0
11/27/2020,714,0,0,4,2118,429,0,0
07-04-2020,735,0,0,8,2126,429,0,0
09/22/2020,746,0,0,3,2129,429,0,0
09-09-2020,130,0,0,1,2128,961,0,0
07/18/2020,600,0,0,12,2132,900,0,0
12-12-2020,735,0,0,12,2136,131,0,0
10/26/2020,413,0,0,6,2110,922,0,0
07-02-2020,553,0,0,6,2118,965,0,0
07/25/2020,733,0,0,11,2135,331,0,0
08/14/2020,745,0,0,1,2128,429,0,0
10/22/2020,714,0,0,8,2126,400,0,0
08/17/2020,745,0,0,4,2118,429,0,0
09/24/2020,552,0,0,9,2131,900,0,0
07-10-2020,412,0,0,4,2118,429,0,0
09/24/2020,740,0,0,9,2119,429,0,0
09-03-2020,554,0,0,12,2136,419,0,0
08/15/2020,600,0,0,1,2128,960,0,0
12/29/2020,712,0,0,4,2111,596,0,0
07-06-2020,113,0,0,4,2118,400,0,0
07-06-2020,522,0,0,9,2120,429,0,0
07/14/2020,743,0,0,11,2135,429,0,0
11-03-2020,735,0,0,11,2134,500,0,0
07/18/2020,745,0,0,9,2119,213,0,0
08/24/2020,553,0,0,12,2132,429,0,0
09/17/2020,522,0,0,3,2113,131,0,0
09-09-2020,554,0,0,4,2116,311,0,0
09-03-2020,714,0,0,9,2120,429,0,0
11-12-2020,735,0,0,7,2124,429,0,0
11/15/2020,735,0,0,4,2215,143,0,0
11/28/2020,553,0,0,12,2131,419,0,0
07/25/2020,733,0,0,6,2127,429,0,0
12/18/2020,113,5,5,9,2119,429,10,0
07-09-2020,621,0,0,8,2124,161,0,0
10/29/2020,745,0,0,3,2108,429,0,0
12/13/2020,553,0,0,4,2116,960,0,0
08-03-2020,714,0,0,3,2108,200,0,0
07/13/2020,511,0,0,4,2120,439,0,0
07/24/2020,745,0,0,3,2110,922,0,0
11/16/2020,553,0,0,12,2131,429,0,0
09/17/2020,733,0,0,3,2110,599,0,0
09/19/2020,745,0,0,7,2121,400,0,0
10/25/2020,500,0,0,8,2124,429,0,0
10/20/2020,555,0,0,4,2215,400,0,0
11-01-2020,600,0,0,3,2114,400,0,0
11/20/2020,150,0,0,7,2122,429,0,0
10/28/2020,733,0,0,9,2119,439,0,0
12-11-2020,600,0,0,11,2135,429,0,0
08/18/2020,552,0,0,7,2125,900,0,0
08-05-2020,553,0,0,4,2115,400,0,0
10/25/2020,553,0,0,3,2109,400,0,0
12-11-2020,113,0,0,11,2135,131,0,0
08-06-2020,553,0,0,7,2125,962,0,0
07/22/2020,553,0,0,4,2215,429,0,0
07/28/2020,735,0,0,3,2114,429,0,0
11-07-2020,745,0,0,6,2127,300,0,0
07-04-2020,700,0,0,7,2122,365,0,0
07-02-2020,551,0,0,1,2128,429,0,0
10/31/2020,745,0,0,9,2115,200,0,0
11-04-2020,555,0,0,3,2129,429,0,0
12-03-2020,600,0,0,6,2125,429,0,0
08/30/2020,900,0,0,12,2132,888,0,0
07/23/2020,600,0,0,6,2210,900,0,0
12-11-2020,113,50,50,4,2118,429,100,0
11/20/2020,743,0,0,4,2116,429,0,0
08/13/2020,553,0,0,9,2119,900,0,0
11/20/2020,714,0,0,12,2136,580,0,0
09/30/2020,553,0,0,12,2132,960,0,0
12-10-2020,554,0,0,9,2119,429,0,0
08-12-2020,700,0,0,12,2132,429,0,0
12-08-2020,743,0,0,4,2111,429,0,0
09/30/2020,735,0,0,6,2127,429,0,0
10-07-2020,553,0,0,3,2129,962,0,0
08/24/2020,714,0,0,4,2115,400,0,0
08/30/2020,554,0,0,11,2135,419,0,0
10/22/2020,553,0,0,4,2116,900,0,0
11/24/2020,500,0,0,9,2119,960,0,0
11-10-2020,745,0,0,9,2130,300,0,0
10/30/2020,714,0,0,9,2130,429,0,0
09/14/2020,743,0,0,9,2132,419,0,0
07-06-2020,600,0,0,8,2122,900,0,0
09/28/2020,700,0,0,4,2115,400,0,0
09/14/2020,554,0,0,8,2124,960,0,0
08/23/2020,500,0,0,11,2134,429,0,0
11/28/2020,743,0,0,12,2132,311,0,0
12/21/2020,553,0,0,4,2115,960,0,0
08-08-2020,553,0,0,1,2128,900,0,0
08/25/2020,745,0,0,4,2118,429,0,0
07-03-2020,731,0,0,6,2125,429,0,0
12-09-2020,745,0,0,9,2119,131,0,0
11-10-2020,553,0,0,4,2215,900,0,0
09-08-2020,553,0,0,11,2134,900,0,0
10/21/2020,555,0,0,1,2128,400,0,0
09/25/2020,600,0,0,12,2131,400,0,0
09/17/2020,440,0,0,1,2128,962,0,0
09/26/2020,745,0,0,3,2109,161,0,0
11/29/2020,412,0,0,11,2135,419,0,0
08-03-2020,743,0,0,8,2126,439,0,0
11/19/2020,553,0,0,6,2127,419,0,0
11-11-2020,400,0,0,8,2124,419,0,0
08-07-2020,652,0,0,6,2127,400,0,0
11-07-2020,746,0,0,3,2129,419,0,0
08/19/2020,622,0,0,3,2129,963,0,0
07/22/2020,736,0,0,1,2128,400,0,0
09/30/2020,714,0,0,3,2114,449,0,0
11/29/2020,714,0,0,6,2127,419,0,0
07/17/2020,700,0,0,7,2118,400,0,0
12/17/2020,745,0,0,9,2121,429,0,0
10-03-2020,740,0,0,9,2115,429,0,0
08-05-2020,511,0,0,7,2125,962,0,0
08/29/2020,442,0,0,12,2132,342,0,0
11/14/2020,736,0,0,6,2127,429,0,0
12/13/2020,735,0,0,12,2132,419,0,0
11-11-2020,552,0,0,12,2136,962,0,0
08/23/2020,733,0,0,11,2135,429,0,0
10/13/2020,113,0,0,12,2131,419,0,0
12-03-2020,553,0,0,9,2119,900,0,0
08-05-2020,553,0,0,1,2128,429,0,0
09-05-2020,600,0,0,1,2128,900,0,0
10-02-2020,745,0,0,6,2118,500,0,0
11/20/2020,553,0,0,3,2114,963,0,0
08-04-2020,500,0,0,11,2134,962,0,0
11/24/2020,714,0,0,3,2108,500,0,0
12-08-2020,400,0,0,12,2136,400,0,0
12/30/2020,553,0,0,6,2210,500,0,0
10/15/2020,714,0,0,3,2129,429,0,0
12/29/2020,553,0,0,8,2124,500,0,0
11/16/2020,715,0,0,6,2127,900,0,0
10/20/2020,736,0,0,11,2135,429,0,0
08/24/2020,553,0,0,11,2135,429,0,0
11/30/2020,440,0,0,12,2136,419,0,0
12/22/2020,500,0,0,12,2136,960,0,0
12/23/2020,511,0,0,6,2127,962,0,0
09/18/2020,553,0,0,1,2128,962,0,0
10-06-2020,171,0,0,12,2131,419,0,0
12/13/2020,743,0,0,4,2118,429,0,0
09/20/2020,745,0,0,7,2118,429,0,0
10/24/2020,745,0,0,7,2119,343,0,0
09/22/2020,736,0,0,8,2124,449,0,0
11-09-2020,745,0,0,3,2113,200,0,0
08-06-2020,553,0,0,3,2129,963,0,0
11/17/2020,553,0,0,7,2125,962,0,0
08/19/2020,550,0,0,8,2126,962,0,0
09/16/2020,743,0,0,4,2118,429,0,0
07/26/2020,553,0,0,4,2118,960,0,0
11/18/2020,714,0,0,4,2118,323,0,0
09-03-2020,736,0,0,9,2121,429,0,0
10-07-2020,553,0,0,1,2128,459,0,0
07/26/2020,554,0,0,6,2127,429,0,0
09-08-2020,522,0,0,7,2122,400,0,0
09/30/2020,412,0,0,4,2118,161,0,0
09/26/2020,735,0,0,11,2135,429,0,0
09/27/2020,600,0,0,4,2115,429,0,0
08-03-2020,553,0,0,8,2126,439,0,0
12/22/2020,733,0,0,4,2118,331,0,0
09/25/2020,113,0,0,8,2124,429,0,0
07/31/2020,553,0,0,9,2467,965,0,0
10/19/2020,651,0,0,8,2126,419,0,0
08/26/2020,743,0,0,7,2125,642,0,0
07-10-2020,741,0,0,8,2126,459,0,0
11-03-2020,553,0,0,4,2118,960,0,0
09/19/2020,743,0,0,12,2131,529,0,0
08-04-2020,553,0,0,12,2136,419,0,0
08-10-2020,733,0,0,8,2124,429,0,0
07/16/2020,745,0,0,4,2111,400,0,0
09/30/2020,553,0,0,8,2126,400,0,0
09/22/2020,554,0,0,8,2124,429,0,0
08/13/2020,743,0,0,4,2116,580,0,0
12-09-2020,740,0,0,4,2215,241,0,0
08/19/2020,553,0,0,4,2118,962,0,0
12/28/2020,553,0,0,6,2127,900,0,0
12-06-2020,553,0,0,6,2127,429,0,0
09/20/2020,553,0,0,11,2135,429,0,0
09-10-2020,743,0,0,12,2132,419,0,0
08-01-2020,733,0,0,6,2127,429,0,0
12/23/2020,400,0,0,9,2119,200,0,0
09/23/2020,740,0,0,4,2118,429,0,0
11/26/2020,113,0,0,8,2124,419,0,0
08/15/2020,511,0,0,3,2113,400,0,0
11/26/2020,113,0,0,11,2135,429,0,0
12-10-2020,511,0,0,8,2122,429,0,0
07-08-2020,735,0,0,11,2163,241,0,0
10/24/2020,745,0,0,7,2124,429,0,0
09/19/2020,151,0,10,9,2119,400,10,0
12-09-2020,743,0,0,4,2115,549,0,0
09/24/2020,113,0,0,9,2120,429,0,0
10-12-2020,143,0,0,7,2118,960,0,0
10-11-2020,713,0,0,7,2119,429,0,0
10/29/2020,553,0,0,12,2131,429,0,0
07/30/2020,744,0,0,8,2126,429,0,0
12/21/2020,553,0,0,12,2132,900,0,0
11-09-2020,621,0,0,8,2122,900,0,0
11-08-2020,553,0,0,3,2114,900,0,0
10/23/2020,600,0,0,3,2129,429,0,0
08-05-2020,600,0,0,12,2132,429,0,0
08/22/2020,553,0,0,3,2114,900,0,0
08/23/2020,553,0,0,9,2121,900,0,0
10/22/2020,735,0,0,9,2119,400,0,0
08/24/2020,743,0,0,9,2119,400,0,0
09-07-2020,553,0,0,7,2124,400,0,0
11-08-2020,745,0,0,6,2127,429,0,0
08-09-2020,500,0,0,11,2135,429,0,0
07-11-2020,735,0,0,4,2120,460,0,0
09/16/2020,553,0,0,3,2113,400,0,0
07-11-2020,735,0,0,1,2128,500,0,0
12/20/2020,424,0,0,12,2130,429,0,0
10-01-2020,621,0,0,6,2127,900,0,0
12/22/2020,621,0,0,6,2118,960,0,0
10/26/2020,733,0,0,4,2118,400,0,0
08/15/2020,746,0,0,9,2120,429,0,0
12/22/2020,651,0,0,8,2124,419,0,0
12/28/2020,553,0,0,7,2121,429,0,0
07/15/2020,553,0,0,1,2128,429,0,0
11/16/2020,714,0,0,4,2118,400,0,0
11-02-2020,743,0,0,8,2124,429,0,0
09/16/2020,554,0,0,11,2135,400,0,0
09-07-2020,553,0,0,9,2119,960,0,0
09/21/2020,743,0,0,7,2119,429,0,0
09-09-2020,714,0,0,3,2129,419,0,0
09-02-2020,113,0,0,6,2210,429,0,0
07/13/2020,553,0,0,4,2118,900,0,0
08-04-2020,553,0,0,1,2128,960,0,0
12-05-2020,745,0,0,3,2110,439,0,0
10/21/2020,553,0,0,9,2119,429,0,0
08/18/2020,400,0,0,3,2109,940,0,0
10/15/2020,553,0,0,4,2118,960,0,0
10/16/2020,745,0,0,6,2127,429,0,0
10-03-2020,553,0,0,8,2126,400,0,0
10/30/2020,813,0,0,7,2121,962,0,0
11/14/2020,714,0,0,4,2116,519,0,0
10/20/2020,740,0,0,9,2130,210,0,0
10-07-2020,444,0,0,9,2131,419,0,0
07/28/2020,745,0,0,8,2124,400,0,0
10-12-2020,736,0,0,6,2127,400,0,0
07/28/2020,441,0,0,12,2131,419,0,0
07-03-2020,522,0,0,7,2121,429,0,0
10-07-2020,553,0,0,7,2125,962,0,0
10/25/2020,553,0,0,7,2121,429,0,0
10-12-2020,113,0,0,12,2136,429,0,0
07/31/2020,424,0,0,3,2129,429,0,0
08/26/2020,411,0,0,7,2125,960,0,0
12/21/2020,745,0,0,9,2130,150,0,0
12-05-2020,553,0,0,11,2135,311,0,0
08/29/2020,553,0,0,4,2118,429,0,0
11-07-2020,714,0,0,4,2116,449,0,0
09-03-2020,553,0,0,4,2116,960,0,0
09/25/2020,743,0,0,11,2134,419,0,0
12-12-2020,554,0,0,9,2120,429,0,0
10-07-2020,745,0,0,12,2132,419,0,0
07/21/2020,745,0,0,9,2119,429,0,0
07-07-2020,736,0,0,11,2135,419,0,0
12-11-2020,553,0,0,4,2115,963,0,0
07-11-2020,113,0,0,9,2120,429,0,0
11/15/2020,745,0,0,6,2127,400,0,0
09/26/2020,641,0,0,9,2130,549,0,0
10/20/2020,714,0,0,4,2116,500,0,0
11/26/2020,715,0,0,7,2124,429,0,0
11-11-2020,743,0,0,12,2131,419,0,0
09-02-2020,553,0,0,7,2118,960,0,0
10/24/2020,553,0,0,4,2119,960,0,0
11-04-2020,743,0,0,3,2113,429,0,0
08/26/2020,745,0,0,3,2129,400,0,0
07-04-2020,651,0,0,7,2122,962,0,0
07-08-2020,554,0,0,8,2124,419,0,0
07-01-2020,745,0,0,12,2136,429,0,0
08-09-2020,142,0,0,8,2124,900,0,0
10-07-2020,553,0,0,12,2130,429,0,0
08/25/2020,743,0,0,8,2122,429,0,0
11-11-2020,745,0,0,8,2124,174,0,0
11/24/2020,500,0,0,11,2135,429,0,0
11-04-2020,715,0,0,11,2135,429,0,0
09-05-2020,424,0,0,1,2128,700,0,0
09-06-2020,745,0,0,7,2122,429,0,0
08/25/2020,715,0,0,4,2115,429,0,0
12/16/2020,740,0,0,11,2135,213,0,0
10-03-2020,511,0,0,6,2127,960,0,0
07/23/2020,511,0,0,12,2131,962,0,0
12-09-2020,735,0,0,6,2127,173,0,0
07-04-2020,111,0,0,9,2119,429,0,0
09-04-2020,553,0,0,4,2215,900,0,0
11/22/2020,714,0,0,7,2118,429,0,0
09-11-2020,500,0,0,9,2120,400,0,0
07/20/2020,553,0,0,11,2135,429,0,0
12/21/2020,746,0,0,9,2130,419,0,0
11/29/2020,551,0,0,12,2136,400,0,0
12/15/2020,154,0,0,3,2129,965,0,0
08-08-2020,600,0,0,12,2132,429,0,0
12/18/2020,745,0,0,11,2135,161,0,0
09/21/2020,554,0,0,8,2126,429,0,0
09/30/2020,746,0,0,6,2210,439,0,0
09/21/2020,553,0,0,3,2108,963,0,0
07-11-2020,553,0,0,6,2127,429,0,0
12-06-2020,553,0,0,4,2215,900,0,0
08/20/2020,745,0,0,7,2122,429,0,0
10/30/2020,611,0,0,6,2210,900,0,0
07/15/2020,113,0,0,12,2132,429,0,0
08-01-2020,113,0,0,12,2130,429,0,0
09-03-2020,522,0,0,9,2119,429,0,0
10/23/2020,553,0,0,12,2131,900,0,0
09/27/2020,553,0,0,12,2131,419,0,0
11/26/2020,113,0,0,8,2124,400,0,0
11-03-2020,553,0,0,1,2128,419,0,0
11-05-2020,714,0,0,4,2115,429,0,0
11/21/2020,553,0,0,9,2119,960,0,0
11/16/2020,735,0,0,9,2130,400,0,0
10/17/2020,522,0,0,8,2126,429,0,0
11/29/2020,113,0,10,9,2119,400,10,0
12/18/2020,553,0,0,6,2127,419,0,0
07/16/2020,744,0,0,4,2118,400,0,0
08/26/2020,413,0,0,8,2126,900,0,0
08-07-2020,736,0,0,6,2127,429,0,0
09-09-2020,743,0,0,6,2210,429,0,0
09-06-2020,733,0,0,12,2136,419,0,0
08-07-2020,553,0,0,9,2119,429,0,0
12/19/2020,553,0,0,4,2215,519,0,0
09-09-2020,600,0,0,4,2118,900,0,0
12/25/2020,611,0,0,8,2126,429,0,0
09/30/2020,550,0,0,11,2135,960,0,0
12/25/2020,736,0,0,3,2129,429,0,0
07-03-2020,600,0,0,4,2115,400,0,0
07/13/2020,554,0,0,12,2131,429,0,0
09-02-2020,733,0,0,6,2127,429,0,0
12/21/2020,554,0,0,11,2135,400,0,0
11/19/2020,745,0,0,4,2116,429,0,0
08-05-2020,745,0,0,3,2129,419,0,0
12/18/2020,700,0,0,11,2135,100,0,0
11-04-2020,554,0,0,12,2126,419,0,0
11-08-2020,500,0,0,11,2135,429,0,0
11/21/2020,554,0,0,7,2122,460,0,0
07/27/2020,733,0,0,3,2110,500,0,0
10-06-2020,736,0,0,4,2116,429,0,0
12-05-2020,733,0,0,8,2124,400,0,0
07/17/2020,424,0,0,6,2127,419,0,0
09/15/2020,736,0,0,12,2132,419,0,0
08/15/2020,113,0,0,7,2122,439,0,0
09/27/2020,731,0,0,4,2215,429,0,0
10-10-2020,553,0,0,9,2120,311,0,0
07/17/2020,745,0,0,7,2121,400,0,0
07/27/2020,714,0,0,9,2130,419,0,0
10/23/2020,745,0,0,4,2115,100,0,0
09/27/2020,553,0,0,7,2125,962,0,0
10/22/2020,745,0,0,6,2210,500,0,0
12/16/2020,553,0,0,11,2135,962,0,0
12/28/2020,714,0,0,4,2115,400,0,0
08/25/2020,552,0,0,4,2116,449,0,0
07/18/2020,745,0,0,7,2119,459,0,0
08-01-2020,553,0,0,6,2125,900,0,0
10/30/2020,444,0,0,12,2136,419,0,0
08/24/2020,600,0,0,12,2132,500,0,0
09/24/2020,553,0,0,11,2134,511,0,0
07/31/2020,740,0,0,4,2118,888,0,0
08/26/2020,553,0,0,3,2114,429,0,0
07-06-2020,554,0,0,4,2115,400,0,0
09/18/2020,553,0,0,7,2119,300,0,0
08-03-2020,600,0,0,6,2118,322,0,0
09/24/2020,745,0,0,12,2136,579,0,0
07-05-2020,711,0,0,8,2124,962,0,0
12-09-2020,553,0,0,4,2115,429,0,0
11/26/2020,424,0,0,9,2120,400,0,0
07-12-2020,553,0,0,6,2127,960,0,0
11/26/2020,424,0,0,11,2134,429,0,0
09/30/2020,745,0,0,12,2131,429,0,0
12/28/2020,714,0,0,9,2119,322,0,0
10/27/2020,151,0,0,1,2128,429,0,0
10/31/2020,552,0,0,6,2125,960,0,0
08/19/2020,712,0,0,3,2110,331,0,0
08/25/2020,554,0,0,9,2119,429,0,0
09/15/2020,745,0,0,3,2114,500,0,0
09-10-2020,714,0,0,4,2118,439,0,0
11/25/2020,651,0,0,12,2132,419,0,0
12/16/2020,552,0,0,8,2121,961,0,0
09-04-2020,733,0,0,4,2115,429,0,0
09-06-2020,745,0,0,7,2125,500,0,0
08/19/2020,745,0,0,9,2121,161,0,0
09/16/2020,714,0,0,11,2134,429,0,0
09-08-2020,735,0,0,4,2111,331,0,0
09/16/2020,745,0,0,12,2136,429,0,0
12/24/2020,736,0,0,12,2131,429,0,0
12-11-2020,735,0,0,4,2118,429,0,0
10-04-2020,733,0,0,11,2135,429,0,0
09/23/2020,741,0,0,3,2108,162,0,0
11-12-2020,714,0,0,4,2116,161,0,0
10/21/2020,746,0,0,6,2127,419,0,0
08-04-2020,600,0,0,4,2115,900,0,0
09/22/2020,743,0,0,3,2114,400,0,0
08-07-2020,715,0,0,3,2113,400,0,0
07/15/2020,715,0,0,9,2121,419,0,0
08/30/2020,554,0,0,9,2130,419,0,0
07/18/2020,746,0,0,6,2127,429,0,0
08-12-2020,553,0,0,4,2118,429,0,0
12-08-2020,554,0,0,12,2132,419,0,0
09/20/2020,553,0,0,4,2118,460,0,0
10-03-2020,710,0,0,9,2119,400,0,0
11/28/2020,511,0,0,4,2199,900,0,0
08-06-2020,552,0,0,6,2127,419,0,0
11/26/2020,554,0,0,7,2119,419,0,0
07-03-2020,553,0,0,8,2124,429,0,0
12-02-2020,745,0,0,7,2125,429,0,0
08-04-2020,743,0,0,8,2126,400,0,0
10/15/2020,600,0,0,12,2132,962,0,0
10/30/2020,745,0,0,3,2113,161,0,0
07-08-2020,652,0,0,11,2215,215,0,0
08-05-2020,440,0,0,11,2135,962,0,0
07/15/2020,553,0,0,11,2135,419,0,0
08-04-2020,553,0,0,3,2114,900,0,0
08-10-2020,743,0,0,9,2120,429,0,0
11-08-2020,553,0,0,9,2119,429,0,0
11-05-2020,553,0,0,12,2131,460,0,0
10-04-2020,745,0,0,11,2135,429,0,0
11/18/2020,740,0,0,9,2119,592,0,0
07/30/2020,424,0,0,12,2131,460,0,0
12/21/2020,745,0,0,3,2108,449,0,0
10/15/2020,553,0,0,3,2114,429,0,0
08-06-2020,743,0,0,1,2128,213,0,0
07/23/2020,710,0,0,4,2118,429,0,0
12/28/2020,651,0,0,7,2119,429,0,0
09-07-2020,735,0,0,11,2134,429,0,0
07-08-2020,712,0,0,4,2115,400,0,0
10/17/2020,116,0,0,8,2124,429,0,0
10-10-2020,554,0,0,8,2124,419,0,0
11/18/2020,745,0,0,12,2131,429,0,0
12-06-2020,553,0,0,8,2124,419,0,0
07/14/2020,745,0,0,9,2130,331,0,0
09-03-2020,743,0,0,4,2115,429,0,0
08-11-2020,500,0,0,8,2124,962,0,0
12/14/2020,553,0,0,4,2120,960,0,0
09-10-2020,113,0,0,9,2119,429,0,0
08/23/2020,522,0,0,6,2127,419,0,0
12/16/2020,714,0,0,4,2116,419,0,0
10-12-2020,553,0,0,6,2127,429,0,0
07/16/2020,700,0,0,9,2115,400,0,0
11-01-2020,112,0,0,8,2126,642,0,0
08/13/2020,553,0,0,12,2130,931,0,0
09/30/2020,553,0,0,11,2134,900,0,0
12-10-2020,151,0,0,7,2125,960,0,0
12-04-2020,553,0,0,3,2111,900,0,0
07/18/2020,511,0,0,8,2124,419,0,0
08/28/2020,736,0,0,9,2130,400,0,0
09-01-2020,412,0,0,7,2119,900,0,0
09-10-2020,712,0,0,4,2199,500,0,0
12/29/2020,553,0,0,3,2109,900,0,0
09/13/2020,651,0,0,7,2125,960,0,0
09/24/2020,745,0,0,8,2126,322,0,0
07/29/2020,745,0,0,6,2127,400,0,0
12/16/2020,511,0,0,6,2127,960,0,0
09-05-2020,711,0,0,4,2118,963,0,0
08/15/2020,142,0,0,8,2124,900,0,0
11-03-2020,745,0,0,4,2118,331,0,0
08-01-2020,715,0,0,7,2125,400,0,0
09-05-2020,500,0,0,4,2120,960,0,0
08/24/2020,743,0,0,9,2115,331,0,0
10/17/2020,651,0,0,12,2131,419,0,0
11-12-2020,113,0,0,6,2127,160,0,0
09/13/2020,553,0,0,4,2115,460,0,0
09/30/2020,553,0,0,9,2120,900,0,0
10/22/2020,553,0,0,4,2215,439,0,0
08-10-2020,553,0,0,6,2118,900,0,0
10-10-2020,113,0,0,4,2116,599,0,0
08-03-2020,553,0,0,7,2118,962,0,0
08/20/2020,553,0,0,6,2127,962,0,0
07/19/2020,554,0,0,12,2136,429,0,0
12-12-2020,554,0,0,8,2126,900,0,0
11-11-2020,500,0,0,12,2132,900,0,0
07-11-2020,600,0,0,4,2118,960,0,0
11-01-2020,113,0,0,7,2124,439,0,0
12-11-2020,553,0,0,3,2114,963,0,0
12-03-2020,553,0,0,7,2121,965,0,0
10/16/2020,600,0,0,4,2116,900,0,0
12-06-2020,553,0,0,6,2118,900,0,0
09/16/2020,500,0,0,12,2131,960,0,0
07/29/2020,652,0,0,6,2210,599,0,0
08/20/2020,745,0,0,11,2135,429,0,0
09-11-2020,735,0,0,6,2127,429,0,0
11-12-2020,500,0,0,9,2121,962,0,0
11/27/2020,600,0,0,6,2118,900,0,0
10/14/2020,553,0,0,3,2114,400,0,0
09-09-2020,113,0,0,11,2134,429,0,0
11/17/2020,554,0,0,12,2132,429,0,0
10/30/2020,553,0,0,6,2127,962,0,0
07/27/2020,714,0,0,7,2124,131,0,0
07/14/2020,553,0,0,9,2130,429,0,0
10-03-2020,553,0,0,6,2127,960,0,0
08/22/2020,600,0,0,11,2135,946,0,0
08/22/2020,552,0,0,1,2128,960,0,0
11/15/2020,600,0,0,7,2121,900,0,0
07/19/2020,600,0,0,9,2124,429,0,0
09/27/2020,600,0,0,11,2134,962,0,0
10/27/2020,553,0,0,1,2128,400,0,0
08/14/2020,413,0,0,6,2210,940,0,0
10-09-2020,600,0,0,3,2113,962,0,0
08-10-2020,745,0,0,11,2135,429,0,0
10/16/2020,714,0,0,7,2122,429,0,0
07/22/2020,735,0,0,6,2210,599,0,0
11/22/2020,714,0,0,8,2124,429,0,0
08/13/2020,113,0,50,11,2134,429,50,0
10/30/2020,553,0,0,4,2116,429,0,0
07-07-2020,714,0,0,4,2118,460,0,0
09/14/2020,553,0,0,1,2128,962,0,0
11/23/2020,553,0,0,3,2203,922,0,0
07/30/2020,745,0,0,4,2116,161,0,0
08-05-2020,735,0,0,9,2130,300,0,0
09/26/2020,553,0,0,4,2116,963,0,0
12-01-2020,745,0,0,6,2118,579,0,0
12/16/2020,714,0,0,8,2126,400,0,0
10/28/2020,714,0,0,8,2126,131,0,0
11/16/2020,745,0,0,12,2136,429,0,0
10/25/2020,651,0,0,7,2124,429,0,0
12/27/2020,554,0,0,9,2119,429,0,0
07/27/2020,554,0,0,6,2125,429,0,0
08-12-2020,413,0,0,9,2121,962,0,0
07/20/2020,511,0,0,6,2125,965,0,0
12/15/2020,554,0,0,9,2130,300,0,0
11/25/2020,554,0,0,8,2126,429,0,0
08/23/2020,553,0,0,6,2210,100,0,0
09/18/2020,714,0,0,4,2215,500,0,0
09/27/2020,735,0,0,8,2122,429,0,0
11/27/2020,733,0,0,3,2129,400,0,0
11/14/2020,735,0,0,6,2127,460,0,0
09/23/2020,142,0,0,9,2215,900,0,0
10/25/2020,555,0,0,1,2128,429,0,0
09-05-2020,552,0,0,7,2125,962,0,0
07/16/2020,712,0,0,4,2118,600,0,0
10/24/2020,735,0,0,9,2119,400,0,0
11/15/2020,554,0,0,11,2135,400,0,0
11/29/2020,600,0,0,6,2125,900,0,0
08-10-2020,600,0,0,3,2114,900,0,0
12-11-2020,553,0,0,4,2118,419,0,0
10/17/2020,735,0,0,12,2131,400,0,0
12-02-2020,554,0,0,4,2118,429,0,0
07/23/2020,734,0,0,3,2108,161,0,0
08-06-2020,653,0,0,1,2128,900,0,0
07/25/2020,735,0,0,11,2135,331,0,0
11/17/2020,600,0,0,7,2119,960,0,0
09/24/2020,553,0,0,12,2132,900,0,0
11/19/2020,553,0,0,1,2128,429,0,0
12/31/2020,745,0,0,12,2130,429,0,0
09/30/2020,500,0,0,12,2136,960,0,0
12/25/2020,715,0,0,8,2122,400,0,0
09/30/2020,444,0,0,12,2131,900,0,0
12-10-2020,735,0,0,3,2110,500,0,0
08-12-2020,714,0,0,8,2126,429,0,0
10/29/2020,553,0,0,9,2119,400,0,0
09/13/2020,553,0,0,4,2118,960,0,0
08/28/2020,553,0,0,9,2119,400,0,0
07/19/2020,553,0,0,3,2113,900,0,0
07/19/2020,553,0,0,8,2126,429,0,0
11-05-2020,745,0,0,3,2114,331,0,0
07-07-2020,552,0,0,8,2124,963,0,0
08-02-2020,600,0,0,8,2126,419,0,0
09/24/2020,553,0,0,9,2130,900,0,0
11/25/2020,600,0,0,3,2110,174,0,0
07/21/2020,714,0,0,3,2110,599,0,0
07/14/2020,553,0,0,4,2118,960,0,0
09/25/2020,553,0,0,11,2134,960,0,0
11/23/2020,742,0,0,3,2109,110,0,0
11/18/2020,113,0,0,11,2134,429,0,0
07/16/2020,550,0,0,8,2136,419,0,0
11/13/2020,743,0,0,7,2125,700,0,0
07/22/2020,551,0,0,12,2131,419,0,0
11/15/2020,600,0,0,3,2114,900,0,0
10-06-2020,553,0,0,4,2115,419,0,0
08-12-2020,553,0,0,9,2119,400,0,0
07/19/2020,714,0,0,4,2118,429,0,0
11-06-2020,651,0,0,4,2215,174,0,0
10-01-2020,743,0,0,12,2132,400,0,0
10/25/2020,552,0,0,8,2124,962,0,0
10-05-2020,553,0,0,4,2118,900,0,0
12-09-2020,424,0,0,6,2127,429,0,0
11/13/2020,743,0,0,9,2115,400,0,0
07/19/2020,735,0,0,4,2118,429,0,0
07-04-2020,553,0,0,6,2118,900,0,0
07/17/2020,712,0,0,4,2118,400,0,0
11-05-2020,744,0,0,9,2119,100,0,0
08/29/2020,500,0,0,8,2124,900,0,0
08-03-2020,745,0,0,12,2132,331,0,0
09/27/2020,900,0,0,6,2210,173,0,0
10/13/2020,735,0,0,3,2109,162,0,0
10/25/2020,735,0,0,11,2215,460,0,0
11-06-2020,553,0,0,6,2118,960,0,0
10-07-2020,714,0,0,6,2125,429,0,0
10-08-2020,113,0,0,4,2115,429,0,0
12/30/2020,745,0,0,11,2135,429,0,0
08/21/2020,553,0,0,12,2136,419,0,0
08-01-2020,553,0,0,4,2118,960,0,0
07/15/2020,736,0,0,7,2122,419,0,0
09/13/2020,551,0,0,4,2120,439,0,0
08/16/2020,743,0,0,6,2127,419,0,0
07/30/2020,511,0,0,12,2131,960,0,0
08/29/2020,511,0,0,11,2135,429,0,0
12/19/2020,550,0,0,1,2128,439,0,0
09/23/2020,553,0,0,8,2126,419,0,0
10/15/2020,700,0,0,6,2127,960,0,0
08/19/2020,551,0,0,12,2132,400,0,0
08/14/2020,731,0,0,4,2215,400,0,0
12/17/2020,441,0,0,3,2114,174,0,0
09/29/2020,551,0,0,8,2126,962,0,0
08-06-2020,553,0,0,3,2129,429,0,0
10-03-2020,743,0,0,8,2124,429,0,0
11/25/2020,444,0,0,6,2127,960,0,0
11-08-2020,522,0,0,11,2135,400,0,0
09-01-2020,554,0,0,9,2130,429,0,0
10-12-2020,500,0,0,11,2135,429,0,0
09/18/2020,730,0,0,4,2116,500,0,0
08-11-2020,553,0,0,12,2132,400,0,0
09-10-2020,600,0,0,9,2130,962,0,0
09-01-2020,600,0,0,7,2125,900,0,0
10/28/2020,553,0,0,4,2115,960,0,0
12/28/2020,116,0,100,8,2124,429,100,0
07-09-2020,420,0,0,12,2131,900,0,0
09/20/2020,745,0,0,12,2136,419,0,0
08/27/2020,743,0,0,11,2135,429,0,0
08/29/2020,710,0,0,7,2125,429,0,0
10-03-2020,622,0,0,3,2129,429,0,0
09-02-2020,745,0,0,1,2128,213,0,0
07/26/2020,553,0,0,8,2126,938,0,0
12/19/2020,554,0,0,6,2125,429,0,0
08/29/2020,733,0,0,1,2128,419,0,0
08-11-2020,553,0,0,12,2132,419,0,0
07/19/2020,113,0,0,9,2120,429,0,0
11-09-2020,733,0,0,3,2129,439,0,0
11-05-2020,553,0,0,4,2111,960,0,0
09-03-2020,600,0,0,6,2125,900,0,0
09-01-2020,745,0,0,12,2136,500,0,0
07-08-2020,651,0,0,9,2130,429,0,0
07/15/2020,553,0,0,9,2119,419,0,0
09/24/2020,500,0,0,4,2118,400,0,0
12/20/2020,735,0,0,4,2116,882,0,0
09/30/2020,553,0,0,12,2136,963,0,0
08/28/2020,715,0,0,9,2121,429,0,0
10-03-2020,554,0,0,11,2135,419,0,0
07-07-2020,553,0,0,1,2128,429,0,0
07/20/2020,553,0,0,1,2128,500,0,0
07/21/2020,734,0,0,4,2116,429,0,0
09/22/2020,552,0,0,8,2124,900,0,0
10/31/2020,400,0,0,4,2118,900,0,0
07-10-2020,445,0,0,9,2119,900,0,0
12-03-2020,622,0,0,9,2130,429,0,0
12/29/2020,160,0,0,11,2215,951,0,0
12/25/2020,113,0,0,9,2119,400,0,0
07/24/2020,600,0,0,3,2114,900,0,0
12-07-2020,444,0,0,12,2132,900,0,0
09-05-2020,500,0,0,11,2135,960,0,0
08-05-2020,554,0,0,12,2131,419,0,0
09-03-2020,550,0,0,12,2132,254,0,0
11/16/2020,651,0,0,11,2135,419,0,0
12-07-2020,113,0,0,3,2109,429,0,0
09-06-2020,522,0,0,6,2210,400,0,0
08-09-2020,553,0,0,3,2113,900,0,0
12/27/2020,412,0,0,3,2113,960,0,0
10-01-2020,735,0,0,4,2215,162,0,0
07/26/2020,730,0,0,7,2119,500,0,0
07-12-2020,745,0,0,9,2121,429,0,0
07/16/2020,113,0,50,11,2135,429,50,0
08/27/2020,600,0,0,7,2125,900,0,0
09-08-2020,553,0,0,1,2128,900,0,0
11/14/2020,113,0,0,9,2120,429,0,0
08/25/2020,553,0,0,11,2135,429,0,0
12/30/2020,740,0,0,4,2118,300,0,0
07-09-2020,651,0,0,11,2134,429,0,0
11-11-2020,714,0,0,11,2135,400,0,0
10-03-2020,553,0,0,3,2113,963,0,0
08-01-2020,745,0,0,8,2126,429,0,0
10/22/2020,745,0,0,11,2134,419,0,0
08-02-2020,622,0,0,8,2124,429,0,0
09/17/2020,552,0,0,6,2127,960,0,0
09/18/2020,745,0,0,12,2131,429,0,0
07/21/2020,151,0,0,8,2124,419,0,0
10/30/2020,554,0,0,7,2125,419,0,0
10/22/2020,714,0,0,4,2115,429,0,0
09-08-2020,651,0,0,8,2122,419,0,0
10-07-2020,413,0,0,4,2116,962,0,0
07/20/2020,743,0,0,11,2135,429,0,0
08/28/2020,113,0,0,3,2110,460,0,0
07/27/2020,743,0,0,6,2127,419,0,0
09/26/2020,711,0,0,11,2134,962,0,0
09/13/2020,553,0,0,4,2115,629,0,0
10-06-2020,743,0,0,12,2132,331,0,0
11-09-2020,735,0,0,8,2124,429,0,0
11-08-2020,511,0,0,1,2128,963,0,0
08/26/2020,561,0,0,4,2116,400,0,0
07-02-2020,553,0,0,7,2125,960,0,0
10-09-2020,715,0,0,8,2122,429,0,0
11-06-2020,113,0,0,4,2115,429,0,0
09-05-2020,745,0,0,3,2109,500,0,0
08/25/2020,553,0,0,4,2116,900,0,0
10/27/2020,551,0,0,8,2124,429,0,0
12-10-2020,113,0,0,11,2134,429,0,0
12-09-2020,745,0,0,4,2116,500,0,0
07/18/2020,554,0,0,3,2129,131,0,0
08/29/2020,735,0,0,9,2121,429,0,0
08/29/2020,745,0,0,9,2121,429,0,0
10-05-2020,740,0,0,3,2110,599,0,0
08-02-2020,714,0,0,6,2127,429,0,0
12/15/2020,553,0,0,6,2127,429,0,0
09-10-2020,735,0,0,9,2130,400,0,0
07/13/2020,553,0,0,9,2131,938,0,0
07/20/2020,621,0,0,12,2136,100,0,0
09/24/2020,553,0,0,9,2119,960,0,0
10/28/2020,500,0,0,8,2122,962,0,0
09-07-2020,553,0,0,3,2114,900,0,0
08/28/2020,736,0,0,6,2127,429,0,0
07-11-2020,522,0,0,11,2135,429,0,0
10-08-2020,553,0,0,9,2119,429,0,0
12/16/2020,424,0,0,7,2122,429,0,0
10/20/2020,553,0,0,3,2108,960,0,0
10/15/2020,113,0,0,7,2121,429,0,0
11/18/2020,113,0,0,3,2114,429,0,0
10/26/2020,714,0,0,3,2114,500,0,0
09-09-2020,600,0,0,4,2115,900,0,0
12/29/2020,553,0,0,8,2126,400,0,0
10-05-2020,600,0,0,4,2115,429,0,0
08-07-2020,715,0,0,9,2130,331,0,0
12-10-2020,551,0,0,9,2121,429,0,0
09-09-2020,735,0,0,11,2135,331,0,0
09-12-2020,553,0,0,4,2115,429,0,0
09-04-2020,743,0,0,9,2120,429,0,0
07-03-2020,743,0,0,3,2111,449,0,0
10/26/2020,412,0,0,7,2122,400,0,0
10/24/2020,113,0,0,7,2121,429,0,0
08-09-2020,553,0,0,3,2114,960,0,0
10/17/2020,735,0,0,7,2122,429,0,0
12/23/2020,742,0,0,4,2118,400,0,0
12/25/2020,522,0,0,6,2127,429,0,0
08/16/2020,553,0,0,7,2121,960,0,0
11-05-2020,735,0,0,6,2127,429,0,0
08/16/2020,553,0,0,3,2109,921,0,0
09-06-2020,715,0,0,8,2124,429,0,0
08/30/2020,552,0,0,12,2136,962,0,0
12/28/2020,745,0,0,12,2131,500,0,0
08-05-2020,151,0,0,12,2467,965,0,0
11/18/2020,714,0,0,3,2113,400,0,0
09/25/2020,424,0,0,7,2119,400,0,0
08/20/2020,740,0,0,4,2116,429,0,0
12-09-2020,745,0,0,3,2108,500,0,0
08-11-2020,553,0,0,7,2121,429,0,0
08/30/2020,745,0,0,7,2125,429,0,0
10/18/2020,553,0,0,7,2121,960,0,0
07/19/2020,712,0,0,9,2132,311,0,0
12-05-2020,733,0,0,3,2113,429,0,0
08/30/2020,553,0,0,11,2135,419,0,0
07-07-2020,622,0,0,4,2115,200,0,0
10-04-2020,424,0,0,7,2125,419,0,0
11/17/2020,733,0,0,7,2121,429,0,0
08/27/2020,746,0,0,7,2122,400,0,0
12/13/2020,113,0,0,9,2120,400,0,0
10/19/2020,113,0,0,4,2215,429,0,0
10/30/2020,553,0,0,9,2130,962,0,0
12/24/2020,550,0,0,4,2215,940,0,0
07-11-2020,714,0,0,12,2136,429,0,0
08/13/2020,444,0,0,11,2134,900,0,0
10-10-2020,500,0,0,4,2120,960,0,0
10-07-2020,553,0,0,8,2124,900,0,0
08/15/2020,734,0,0,8,2124,131,0,0
07-11-2020,745,0,0,6,2210,161,0,0
10-06-2020,622,0,0,7,2121,900,0,0
12/26/2020,714,0,0,4,2118,419,0,0
07/18/2020,142,0,0,9,2131,900,0,0
10-05-2020,522,0,0,3,2110,174,0,0
09/24/2020,400,0,0,6,2127,429,0,0
08-10-2020,714,0,0,3,2113,400,0,0
08/19/2020,735,0,0,3,2109,599,0,0
09-03-2020,600,0,0,6,2125,900,0,0
08-12-2020,714,0,0,8,2124,210,0,0
09-01-2020,412,0,0,11,2134,429,0,0
11/13/2020,714,0,0,4,2115,429,0,0
10-09-2020,745,0,0,11,2134,160,0,0
08-06-2020,113,20,20,4,2116,400,40,0
07-04-2020,442,0,0,9,2119,400,0,0
10/15/2020,735,0,0,1,2128,429,0,0
07/17/2020,745,0,0,12,2126,400,0,0
11/23/2020,736,0,0,8,2124,429,0,0
08-11-2020,745,0,0,6,2127,419,0,0
08-08-2020,412,0,0,12,2131,900,0,0
09-03-2020,522,0,0,8,2126,429,0,0
11/28/2020,622,0,0,9,2130,429,0,0
08/27/2020,553,0,0,7,2118,429,0,0
10/30/2020,553,0,0,3,2114,419,0,0
09-01-2020,553,0,0,12,2131,960,0,0
10-07-2020,553,0,0,7,2118,960,0,0
09-09-2020,553,0,0,3,2109,900,0,0
09/19/2020,740,0,0,8,2122,429,0,0
07-10-2020,552,0,0,6,2118,900,0,0
12/27/2020,600,0,0,8,2124,459,0,0
08/24/2020,743,0,0,4,2215,123,0,0
07/22/2020,550,0,0,3,2109,941,0,0
11-06-2020,652,0,0,7,2122,160,0,0
10-09-2020,600,0,0,4,2118,900,0,0
09/28/2020,113,0,0,7,2121,439,0,0
11-08-2020,714,0,0,4,2118,439,0,0
08-03-2020,553,0,0,4,2118,962,0,0
11/14/2020,553,0,0,6,2127,429,0,0
07-01-2020,553,0,0,9,2119,963,0,0
12-01-2020,733,0,0,4,2116,429,0,0
07/15/2020,714,0,0,4,2115,429,0,0
10/18/2020,743,0,0,12,2136,429,0,0
08/19/2020,743,0,0,4,2215,429,0,0
08-02-2020,731,0,0,4,2111,170,0,0
10/14/2020,553,0,0,3,2114,400,0,0
09/19/2020,733,0,0,4,2111,429,0,0
08-01-2020,553,0,0,11,2134,960,0,0
09-03-2020,710,0,0,9,2120,419,0,0
11-09-2020,444,0,0,7,2119,400,0,0
12/17/2020,714,0,0,11,2134,519,0,0
09/25/2020,600,0,0,3,2108,962,0,0
07/22/2020,440,0,0,1,2128,900,0,0
12/17/2020,424,0,0,6,2127,419,0,0
08/17/2020,553,0,0,9,2130,429,0,0
08/26/2020,900,0,0,6,2127,459,0,0
10/13/2020,553,0,0,1,2128,962,0,0
11-07-2020,552,0,0,6,2127,429,0,0
07-07-2020,553,0,0,8,2124,419,0,0
09/25/2020,553,0,0,9,2130,400,0,0
11-07-2020,553,0,0,12,2132,400,0,0
12-04-2020,745,0,0,1,2128,161,0,0
08/23/2020,733,0,0,12,2136,429,0,0
09/14/2020,743,0,0,12,2131,429,0,0
09/17/2020,552,0,0,8,2126,965,0,0
08-03-2020,553,0,0,12,2131,439,0,0
08/27/2020,736,0,0,9,2120,429,0,0
12-07-2020,553,0,0,6,2118,900,0,0
09/15/2020,600,0,0,4,2116,400,0,0
12/21/2020,600,0,0,4,2199,900,0,0
09-04-2020,743,0,0,4,2116,500,0,0
10-08-2020,745,0,0,3,2109,519,0,0
10/26/2020,742,0,0,6,2125,500,0,0
12/14/2020,553,0,0,9,2115,419,0,0
11/21/2020,554,0,0,9,2119,400,0,0
08/23/2020,553,0,0,4,2215,963,0,0
08/23/2020,553,0,0,4,2215,960,0,0
07/30/2020,651,0,0,8,2126,419,0,0
10/25/2020,600,0,0,6,2210,900,0,0
07-10-2020,743,0,0,4,2215,460,0,0
09/14/2020,553,0,0,3,2108,419,0,0
10/20/2020,553,0,0,4,2118,429,0,0
08/23/2020,553,0,0,7,2121,900,0,0
11-04-2020,500,0,0,9,2130,963,0,0
07-10-2020,553,0,0,4,2116,900,0,0
10-02-2020,500,0,0,12,2131,962,0,0
10-06-2020,745,0,0,7,2125,500,0,0
08-04-2020,444,0,0,11,2134,963,0,0
11/24/2020,113,0,0,9,2115,331,0,0
07/19/2020,553,0,0,7,2119,900,0,0
10-07-2020,745,0,0,11,2134,429,0,0
12/15/2020,745,0,0,1,2128,644,0,0
09-03-2020,553,0,0,7,2121,429,0,0
08/21/2020,154,0,0,3,2109,963,0,0
10/27/2020,552,0,0,4,2116,960,0,0
10/22/2020,735,0,0,4,2116,400,0,0
09/30/2020,553,0,0,4,2111,331,0,0
12/31/2020,553,0,0,6,2118,300,0,0
09-12-2020,600,0,0,9,2121,900,0,0
07/13/2020,600,0,0,6,2125,173,0,0
10-01-2020,553,0,0,6,2127,900,0,0
07/24/2020,715,0,0,8,2124,429,0,0
10/15/2020,600,0,0,9,2119,962,0,0
09-10-2020,900,0,0,4,2116,210,0,0
11-07-2020,131,0,0,7,2125,960,0,0
07/13/2020,113,0,0,9,2120,460,0,0
12/30/2020,500,0,0,8,2126,400,0,0
11/30/2020,554,0,0,12,2136,459,0,0
10-09-2020,715,0,0,4,2118,429,0,0
10/29/2020,611,0,0,8,2126,960,0,0
09/25/2020,553,0,0,3,2109,300,0,0
10/14/2020,553,0,0,8,2126,419,0,0
07-03-2020,714,0,0,7,2125,400,0,0
10/16/2020,746,0,0,3,2113,419,0,0
12-09-2020,735,0,0,3,2111,429,0,0
09/17/2020,552,0,0,6,2125,960,0,0
10-02-2020,553,0,0,3,2113,429,0,0
09/19/2020,714,0,0,1,2128,564,0,0
10-01-2020,113,0,0,7,2119,429,0,0
12/16/2020,621,0,0,6,2127,960,0,0
07-10-2020,142,0,0,9,2130,931,0,0
11-05-2020,741,0,0,3,2109,429,0,0
08-03-2020,511,0,0,9,2130,900,0,0
09/17/2020,553,0,0,6,2127,429,0,0
10/22/2020,554,0,0,8,2124,311,0,0
09/17/2020,555,0,0,4,2118,400,0,0
09/22/2020,600,0,0,4,2118,900,0,0
12/19/2020,553,0,0,8,2124,429,0,0
08/14/2020,553,0,0,11,2135,400,0,0
11-04-2020,735,0,0,11,2135,429,0,0
08-04-2020,745,0,0,4,2116,500,0,0
08/28/2020,460,0,0,9,2119,962,0,0
09-11-2020,600,0,0,8,2126,962,0,0
08/18/2020,151,0,0,12,2132,963,0,0
09/13/2020,745,0,0,6,2127,429,0,0
10/26/2020,500,0,0,1,2127,900,0,0
12-03-2020,715,0,0,9,2119,419,0,0
08-04-2020,550,0,0,3,2129,962,0,0
12/17/2020,511,0,0,6,2127,962,0,0
08/19/2020,554,0,0,12,2136,419,0,0
07-09-2020,715,0,0,8,2124,900,0,0
10/19/2020,700,0,0,8,2124,429,0,0
08-01-2020,113,0,0,8,2124,429,0,0
11/16/2020,743,0,0,11,2134,419,0,0
08/30/2020,553,0,0,1,2128,400,0,0
11-07-2020,715,0,0,12,2130,400,0,0
09-04-2020,424,0,0,1,2128,700,0,0
08-09-2020,735,0,0,6,2127,984,0,0
08/19/2020,551,0,0,7,2121,429,0,0
12-10-2020,743,0,0,11,2135,400,0,0
10/31/2020,714,0,0,4,2115,429,0,0
10-04-2020,735,0,0,9,2121,400,0,0
10/21/2020,553,0,0,4,2115,429,0,0
09-08-2020,715,0,0,6,2127,419,0,0
07/25/2020,731,0,0,4,2120,174,0,0
12/24/2020,522,0,0,4,2116,429,0,0
09/18/2020,600,0,0,12,2131,900,0,0
10/27/2020,113,0,0,12,2136,460,0,0
12-11-2020,700,0,0,3,2109,161,0,0
12-05-2020,714,0,0,7,2118,150,0,0
12/17/2020,743,0,0,3,2129,600,0,0
11/21/2020,553,0,0,12,2130,429,0,0
10/26/2020,746,0,0,8,2126,419,0,0
07/14/2020,621,0,0,4,2118,900,0,0
08-06-2020,553,0,0,4,2118,962,0,0
09-02-2020,553,0,0,12,2131,960,0,0
12/14/2020,746,0,0,3,2113,429,0,0
09/17/2020,743,0,0,7,2119,400,0,0
09-09-2020,553,0,0,1,2128,962,0,0
10/28/2020,715,0,0,4,2118,300,0,0
11/22/2020,715,0,0,6,2127,419,0,0
11/14/2020,743,0,0,6,2210,500,0,0
10-05-2020,743,0,0,4,2118,400,0,0
07/16/2020,552,0,0,3,2113,963,0,0
09-05-2020,744,0,0,7,2125,400,0,0
09/18/2020,553,0,0,9,2119,300,0,0
10/20/2020,554,0,0,8,2126,429,0,0
12-05-2020,553,0,0,7,2125,419,0,0
12-05-2020,113,0,0,9,2130,419,0,0
08-03-2020,714,0,0,4,2215,200,0,0
10/27/2020,714,0,0,9,2119,429,0,0
10/27/2020,554,0,0,3,2114,449,0,0
09/14/2020,151,0,0,3,2129,951,0,0
07-01-2020,113,0,0,9,2115,429,0,0
09/14/2020,733,0,0,9,2130,429,0,0
10/30/2020,745,0,0,6,2118,952,0,0
07-08-2020,440,0,0,9,2130,963,0,0
08/13/2020,745,0,0,8,2126,429,0,0
09/20/2020,553,0,0,6,2127,960,0,0
08/26/2020,553,0,0,4,2116,131,0,0
11/14/2020,743,0,0,4,2111,400,0,0
07/24/2020,553,0,0,6,2119,900,0,0
07/25/2020,743,0,0,1,2128,647,0,0
10/24/2020,113,0,0,1,2128,429,0,0
12/25/2020,113,0,0,6,2125,400,0,0
10/14/2020,735,0,0,3,2108,400,0,0
11/20/2020,600,0,0,4,2111,963,0,0
10-12-2020,522,0,0,7,2119,960,0,0
10-07-2020,553,0,0,6,2127,429,0,0
11/16/2020,745,0,0,4,2111,599,0,0
12/31/2020,424,0,0,8,2126,419,0,0
10/16/2020,500,0,0,12,2131,161,0,0
08/15/2020,714,0,0,7,2121,429,0,0
10/16/2020,735,0,0,3,2111,500,0,0
11/26/2020,715,0,0,3,2129,400,0,0
10/22/2020,700,0,0,4,2116,400,0,0
12/26/2020,553,0,0,1,2128,429,0,0
10/15/2020,712,0,0,3,2114,150,0,0
09/25/2020,743,0,0,6,2125,429,0,0
10/22/2020,400,0,0,9,2130,419,0,0
09/17/2020,553,0,0,3,2114,900,0,0
11-02-2020,743,0,0,4,2116,460,0,0
12/31/2020,745,0,0,9,2121,439,0,0
09-11-2020,743,0,0,9,2115,460,0,0
12-02-2020,553,0,0,9,2121,900,0,0
10-02-2020,552,0,0,8,2126,962,0,0
09/30/2020,732,0,0,3,2114,331,0,0
11/23/2020,746,0,0,9,2120,400,0,0
12/19/2020,553,0,0,3,2114,900,0,0
08/22/2020,522,0,0,11,2135,429,0,0
07-12-2020,500,0,0,7,2121,419,0,0
09-05-2020,553,0,0,6,2127,960,0,0
08/21/2020,743,0,0,7,2119,400,0,0
08-04-2020,553,0,0,4,2118,960,0,0
09-02-2020,700,0,0,4,2118,429,0,0
09/26/2020,600,0,0,4,2116,400,0,0
12/17/2020,745,0,0,3,2108,200,0,0
11-06-2020,711,0,0,7,2122,960,0,0
09-09-2020,714,0,0,3,2114,311,0,0
12/19/2020,715,0,0,8,2124,429,0,0
10/23/2020,743,0,0,8,2126,429,0,0
09-06-2020,651,0,0,12,2131,429,0,0
12/25/2020,735,0,0,12,2132,599,0,0
11-02-2020,735,0,0,3,2108,500,0,0
08-03-2020,745,0,0,4,2111,429,0,0
10/22/2020,743,0,0,4,2215,460,0,0
12-07-2020,622,0,0,4,2199,429,0,0
07/28/2020,745,0,0,6,2127,429,0,0
12/16/2020,714,0,0,7,2121,429,0,0
07/15/2020,553,0,0,4,2118,900,0,0
07-10-2020,743,0,0,8,2124,429,0,0
12/29/2020,441,0,0,3,2129,429,0,0
08-08-2020,700,0,0,1,2128,429,0,0
11-08-2020,735,0,0,4,2215,200,0,0
07-01-2020,554,0,0,12,2130,429,0,0
10/20/2020,553,0,0,6,2127,419,0,0
09-05-2020,412,0,0,4,2116,500,0,0
09/22/2020,550,0,0,6,2127,429,0,0
12-10-2020,113,10,10,4,2199,500,20,0
07/22/2020,113,0,0,4,2115,429,0,0
08-05-2020,553,0,0,3,2113,429,0,0
08/19/2020,714,0,0,12,2130,400,0,0
07/14/2020,522,0,0,4,2215,439,0,0
09/20/2020,553,0,0,1,2128,419,0,0
07/23/2020,733,0,0,7,2119,639,0,0
07-05-2020,553,0,0,3,2108,900,0,0
11-04-2020,522,0,0,4,2116,429,0,0
08/20/2020,733,0,0,3,2129,131,0,0
11-11-2020,745,0,0,3,2110,519,0,0
12/24/2020,733,0,0,9,2115,331,0,0
12/23/2020,735,0,0,9,2119,429,0,0
11-08-2020,113,0,0,3,2113,429,0,0
11/17/2020,553,0,0,8,2126,419,0,0
07/14/2020,713,0,0,12,2131,500,0,0
11/18/2020,553,0,0,9,2119,419,0,0
10/20/2020,500,0,0,12,2136,114,0,0
10-06-2020,733,0,0,6,2127,429,0,0
09-03-2020,735,0,0,4,2215,174,0,0
07/28/2020,600,0,0,4,2111,429,0,0
07/25/2020,440,0,0,8,2126,960,0,0
08-11-2020,651,0,0,12,2131,400,0,0
08-11-2020,553,0,0,12,2132,965,0,0
11-07-2020,552,0,0,7,2119,960,0,0
10/30/2020,552,0,0,7,2121,962,0,0
11-09-2020,741,0,0,12,2132,331,0,0
07/13/2020,422,0,0,9,2130,419,0,0
10/19/2020,736,0,0,4,2215,161,0,0
09/19/2020,553,0,0,12,2132,900,0,0
07/15/2020,553,0,0,1,2128,962,0,0
08-11-2020,553,0,0,4,2118,960,0,0
12-01-2020,714,0,0,8,2126,400,0,0
08/15/2020,743,0,0,4,2118,429,0,0
12/23/2020,554,0,0,11,2135,429,0,0
07/16/2020,652,0,0,11,2135,331,0,0
07/26/2020,113,0,0,7,2121,429,0,0
08/28/2020,151,0,0,9,2120,962,0,0
09-09-2020,700,0,0,4,2115,200,0,0
08-03-2020,553,0,0,6,2125,960,0,0
08/20/2020,553,0,0,3,2129,965,0,0
08/29/2020,743,0,0,3,2114,429,0,0
07/29/2020,553,0,0,9,2120,900,0,0
11-04-2020,745,0,0,3,2110,599,0,0
07/26/2020,511,0,0,11,2135,419,0,0
08-12-2020,735,0,0,9,2130,331,0,0
09-10-2020,745,0,0,12,2132,100,0,0
09/30/2020,600,0,0,12,2136,419,0,0
07-08-2020,553,0,0,4,2116,429,0,0
08-01-2020,715,0,0,3,2114,429,0,0
08-05-2020,444,0,0,9,2215,900,0,0
12/31/2020,553,0,0,8,2126,429,0,0
10/14/2020,553,0,0,7,2125,962,0,0
07/25/2020,553,0,0,4,2115,900,0,0
10/26/2020,745,0,0,11,2467,400,0,0
07/19/2020,553,0,0,1,2128,965,0,0
11/21/2020,554,0,0,8,2124,300,0,0
12-10-2020,440,0,0,4,2116,429,0,0
11/22/2020,500,0,0,4,2118,429,0,0
11/15/2020,714,0,0,9,2130,429,0,0
09/13/2020,652,0,0,4,2120,449,0,0
10/21/2020,551,0,0,7,2124,429,0,0
12-07-2020,714,0,0,12,2131,400,0,0
07/24/2020,651,0,0,7,2121,429,0,0
09-12-2020,621,0,0,7,2125,960,0,0
10-12-2020,735,0,0,4,2115,500,0,0
10-12-2020,553,0,0,9,2119,400,0,0
11/16/2020,412,0,0,4,2118,400,0,0
09-06-2020,412,0,0,12,2131,419,0,0
10/20/2020,553,0,0,8,2126,429,0,0
09/16/2020,652,0,0,6,2127,174,0,0
08/19/2020,714,0,0,9,2120,429,0,0
09-04-2020,600,0,0,12,2124,900,0,0
09/19/2020,714,0,0,4,2116,429,0,0
11/19/2020,735,0,0,9,2115,400,0,0
08/13/2020,611,0,0,4,2118,960,0,0
09/17/2020,743,0,0,12,2132,331,0,0
08-05-2020,142,0,0,11,2135,900,0,0
10/20/2020,651,0,0,9,2130,429,0,0
08/21/2020,600,0,0,4,2118,962,0,0
09/14/2020,113,15,15,6,2127,429,30,0
10/30/2020,600,0,0,3,2114,960,0,0
10-07-2020,553,0,0,12,2136,962,0,0
09-05-2020,736,0,0,8,2126,419,0,0
09-03-2020,745,0,0,1,2128,429,0,0
11-11-2020,652,0,0,4,2115,400,0,0
10/17/2020,113,0,0,7,2125,419,0,0
10/23/2020,553,0,0,4,2118,960,0,0
08-03-2020,554,0,0,9,2115,400,0,0
12/21/2020,553,0,0,4,2118,429,0,0
09/22/2020,561,0,0,12,2136,891,0,0
09/29/2020,554,0,0,11,2135,400,0,0
10/31/2020,621,0,0,7,2122,429,0,0
08-11-2020,600,0,0,7,2125,429,0,0
08/14/2020,553,0,0,7,2118,963,0,0
08/25/2020,600,0,0,4,2118,960,0,0
07-11-2020,552,0,0,4,2115,888,0,0
08-03-2020,600,0,0,7,2121,429,0,0
11-06-2020,413,0,0,7,2119,900,0,0
07-10-2020,735,0,0,3,2114,400,0,0
08-09-2020,600,0,0,12,2136,419,0,0
11-01-2020,734,0,0,9,2130,400,0,0
09/30/2020,553,0,0,12,2132,900,0,0
09-09-2020,553,0,0,6,2127,429,0,0
07/19/2020,745,0,0,6,2210,400,0,0
10/22/2020,734,0,0,6,2127,429,0,0
10-12-2020,712,0,0,12,2131,460,0,0
10-04-2020,554,0,0,9,2121,900,0,0
11/24/2020,500,0,0,9,2130,400,0,0
09/16/2020,745,0,0,3,2111,599,0,0
07/21/2020,735,0,0,11,2135,429,0,0
10/21/2020,711,0,0,12,2132,962,0,0
12/28/2020,553,0,0,12,2131,400,0,0
07-08-2020,735,0,0,6,2127,429,0,0
07/24/2020,745,0,0,3,2108,100,0,0
10/15/2020,553,0,0,8,2124,429,0,0
09-01-2020,711,0,0,7,2121,960,0,0
11/27/2020,743,0,0,4,2111,429,0,0
07-01-2020,553,0,0,3,2114,300,0,0
07/21/2020,744,0,0,6,2210,700,0,0
08-04-2020,813,0,0,9,2130,962,0,0
12/27/2020,714,0,0,12,2136,419,0,0
09-03-2020,715,0,0,4,2118,429,0,0
12-04-2020,113,0,0,9,2130,429,0,0
10-10-2020,142,0,0,3,2129,900,0,0
07-10-2020,733,0,0,9,2119,400,0,0
11-11-2020,745,0,0,9,2121,429,0,0
08/15/2020,142,0,0,12,2131,961,0,0
12-11-2020,113,0,0,8,2124,429,0,0
10-11-2020,600,0,0,4,2118,965,0,0
10/20/2020,714,0,0,4,2118,429,0,0
08/23/2020,712,0,0,3,2114,400,0,0
09/19/2020,550,0,0,12,2131,962,0,0
10-08-2020,651,0,0,4,2118,429,0,0
12/20/2020,113,0,0,6,2125,400,0,0
11-02-2020,712,0,0,9,2115,331,0,0
09-06-2020,552,0,0,4,2118,900,0,0
10/13/2020,554,0,0,8,2124,419,0,0
12/18/2020,113,0,0,9,2115,460,0,0
09/15/2020,118,0,0,4,2215,429,0,0
07/16/2020,600,0,0,4,2115,200,0,0
07/19/2020,511,0,0,9,2120,429,0,0
08-05-2020,745,0,0,6,2210,500,0,0
07/20/2020,711,0,0,11,2134,963,0,0
07/27/2020,500,0,0,11,2135,429,0,0
12/22/2020,500,0,0,8,2126,962,0,0
11/18/2020,553,0,0,9,2115,254,0,0
12-04-2020,714,0,0,6,2127,429,0,0
12-11-2020,553,0,0,1,2128,963,0,0
07-09-2020,553,0,0,6,2119,900,0,0
09/22/2020,522,0,0,12,2136,110,0,0
10-07-2020,600,0,0,8,2124,429,0,0
09-09-2020,714,0,0,4,2215,460,0,0
11-02-2020,554,0,0,8,2124,429,0,0
07-11-2020,715,0,0,9,2130,419,0,0
08/22/2020,554,0,0,3,2114,900,0,0
07/29/2020,715,0,0,6,2125,400,0,0
11/23/2020,600,0,0,4,2116,900,0,0
10/31/2020,743,0,0,12,2136,419,0,0
08-05-2020,700,0,0,9,2115,300,0,0
09/24/2020,522,0,0,11,2134,429,0,0
10/16/2020,735,0,0,8,2126,429,0,0
07-09-2020,553,0,0,7,2122,900,0,0
07-03-2020,554,0,0,9,2132,311,0,0
08-06-2020,113,0,0,11,2135,400,0,0
07-08-2020,553,0,0,12,2136,419,0,0
09-01-2020,413,0,0,7,2125,960,0,0
07/23/2020,522,0,0,12,2131,459,0,0
07/28/2020,554,0,0,4,2118,439,0,0
08-07-2020,745,0,0,9,2120,419,0,0
09/28/2020,553,0,0,6,2118,500,0,0
08/31/2020,900,0,0,9,2130,213,0,0
10-07-2020,552,0,0,8,2124,952,0,0
07/19/2020,745,0,0,6,2210,400,0,0
07-11-2020,553,0,0,8,2124,900,0,0
11/16/2020,113,0,0,9,2120,429,0,0
11-11-2020,553,0,0,4,2120,960,0,0
08/14/2020,553,0,0,7,2119,900,0,0
09-01-2020,553,0,0,12,2131,300,0,0
09-08-2020,550,0,0,7,2125,500,0,0
11-03-2020,745,0,0,4,2111,429,0,0
10-07-2020,550,0,0,1,2128,962,0,0
07-03-2020,511,0,0,6,2127,900,0,0
10-03-2020,424,0,0,6,2127,400,0,0
11-07-2020,553,0,0,8,2124,960,0,0
11-12-2020,735,0,0,3,2108,400,0,0
08-12-2020,444,0,0,1,2128,962,0,0
09/17/2020,142,0,0,12,2131,900,0,0
09/25/2020,743,0,0,7,2125,429,0,0
10-08-2020,711,0,0,4,2118,960,0,0
09-03-2020,113,25,25,6,2127,429,50,0
08-01-2020,553,0,0,8,2126,419,0,0
08-10-2020,553,0,0,6,2127,460,0,0
11/17/2020,715,0,0,11,2135,429,0,0
08/18/2020,735,0,0,12,2136,549,0,0
12/16/2020,743,0,0,11,2135,429,0,0
07/23/2020,743,0,0,7,2119,639,0,0
10/22/2020,745,0,0,3,2203,965,0,0
10/19/2020,554,0,0,12,2132,429,0,0
10/14/2020,550,0,0,11,2135,419,0,0
09/29/2020,735,0,0,9,2130,400,0,0
09-08-2020,743,0,0,4,2115,429,0,0
07/25/2020,600,0,0,3,2113,429,0,0
07-10-2020,154,0,0,9,2120,900,0,0
12-12-2020,113,0,0,11,2134,500,0,0
12-09-2020,442,0,0,4,2118,449,0,0
11-08-2020,743,0,0,3,2109,429,0,0
07/20/2020,150,0,0,4,2118,960,0,0
11-08-2020,715,0,0,9,2130,419,0,0
07/14/2020,541,0,0,11,2135,962,0,0
10/29/2020,714,0,0,12,2130,429,0,0
07/17/2020,621,0,0,3,2108,963,0,0
12-09-2020,440,0,0,12,2131,960,0,0
12/20/2020,113,0,0,9,2130,419,0,0
11/30/2020,554,0,0,3,2109,429,0,0
09/22/2020,733,0,0,3,2114,400,0,0
07-08-2020,444,0,0,6,2127,960,0,0
07-08-2020,745,0,0,6,2127,400,0,0
07/13/2020,553,0,0,4,2116,254,0,0
11-09-2020,733,0,0,4,2115,429,0,0
10/13/2020,553,0,0,12,2132,500,0,0
12-12-2020,511,0,0,7,2121,429,0,0
09/29/2020,731,0,0,9,2115,429,0,0
07-10-2020,553,0,0,3,2109,900,0,0
08-07-2020,744,0,0,3,2110,500,0,0
10/31/2020,553,0,0,4,2116,429,0,0
10-11-2020,553,0,0,6,2118,900,0,0
10-07-2020,714,0,0,12,2131,161,0,0
12/28/2020,553,0,0,1,2128,419,0,0
09/19/2020,554,0,0,9,2120,400,0,0
09-07-2020,735,0,0,4,2115,549,0,0
12/31/2020,552,0,0,8,2124,429,0,0
10/22/2020,600,0,0,9,2119,960,0,0
08/29/2020,413,0,0,7,2121,960,0,0
10-02-2020,700,0,0,1,2128,171,0,0
08/24/2020,553,0,0,4,2111,960,0,0
07/23/2020,651,0,0,6,2127,400,0,0
12/23/2020,714,0,0,4,2116,400,0,0
12/17/2020,444,0,0,9,2131,419,0,0
09/29/2020,553,0,0,6,2118,900,0,0
09/30/2020,813,0,0,11,2135,962,0,0
12/24/2020,745,0,0,8,2126,419,0,0
07-08-2020,611,0,0,8,2122,519,0,0
12/26/2020,745,0,0,7,2125,429,0,0
11-11-2020,142,0,0,8,2124,938,0,0
10/28/2020,553,0,0,6,2125,965,0,0
12-11-2020,714,0,0,9,2130,181,0,0
09/19/2020,745,0,0,3,2114,400,0,0
10/21/2020,743,0,0,3,2129,419,0,0
12/25/2020,732,0,0,4,2118,882,0,0
07/24/2020,714,0,0,9,2120,400,0,0
10-09-2020,113,0,50,8,2124,419,50,0
11/18/2020,522,0,0,4,2118,429,0,0
10/16/2020,700,0,0,8,2124,429,0,0
09/29/2020,554,0,0,12,2131,419,0,0
08/17/2020,553,0,0,1,2128,174,0,0
07-09-2020,113,0,0,11,2134,429,0,0
08/19/2020,551,0,0,9,2132,400,0,0
09/16/2020,611,0,0,8,2126,429,0,0
07/23/2020,735,0,0,7,2122,429,0,0
09/26/2020,553,0,0,4,2215,900,0,0
11/22/2020,900,0,0,6,2210,173,0,0
09-10-2020,600,0,0,4,2118,960,0,0
11/18/2020,600,0,0,3,2113,400,0,0
08/29/2020,745,0,0,7,2125,429,0,0
10-07-2020,552,0,0,3,2114,900,0,0
08-12-2020,553,0,0,6,2127,419,0,0
10/14/2020,713,0,0,11,2135,400,0,0
08-02-2020,112,0,0,11,2135,419,0,0
12/28/2020,413,0,0,11,2163,961,0,0
11-10-2020,621,0,0,4,2115,900,0,0
08-06-2020,735,0,0,4,2116,500,0,0
12-09-2020,714,0,0,3,2129,300,0,0
10/16/2020,500,0,0,6,2127,962,0,0
08/15/2020,113,0,0,11,2135,419,0,0
12-08-2020,553,0,0,6,2127,900,0,0
10/13/2020,424,0,0,4,2199,400,0,0
11/25/2020,745,0,0,3,2113,429,0,0
12-05-2020,553,0,0,4,2118,400,0,0
08/15/2020,600,0,0,7,2125,400,0,0
08-10-2020,553,0,0,4,2115,960,0,0
10/14/2020,743,0,0,8,2126,400,0,0
08-11-2020,553,0,0,6,2127,173,0,0
10/21/2020,745,0,0,3,2114,174,0,0
11-09-2020,651,0,0,7,2119,429,0,0
08/26/2020,522,0,0,11,2135,400,0,0
07/23/2020,736,0,0,9,2119,960,0,0
10/18/2020,712,0,0,7,2118,429,0,0
09/15/2020,553,0,0,7,2119,963,0,0
08/16/2020,522,0,0,4,2116,131,0,0
07/13/2020,735,0,0,4,2116,429,0,0
09-05-2020,113,0,0,6,2127,400,0,0
10-03-2020,735,0,0,11,2135,429,0,0
09-04-2020,553,0,0,4,2118,900,0,0
11/21/2020,553,0,0,9,2119,173,0,0
07/26/2020,553,0,0,7,2121,429,0,0
08-12-2020,745,0,0,4,2116,529,0,0
10-03-2020,743,0,0,8,2124,460,0,0
07/23/2020,143,0,0,1,2128,900,0,0
08/16/2020,553,0,0,7,2119,962,0,0
12/17/2020,553,0,0,3,2108,960,0,0
11-02-2020,745,0,0,4,2215,241,0,0
10-10-2020,743,0,0,4,2118,400,0,0
12-10-2020,113,0,0,12,2136,400,0,0
12/21/2020,735,0,0,6,2127,429,0,0
07/26/2020,554,0,0,1,2128,419,0,0
07-03-2020,522,0,0,7,2121,429,0,0
11/13/2020,553,0,0,11,2135,400,0,0
09/16/2020,714,0,0,6,2127,511,0,0
08/22/2020,554,0,0,4,2115,400,0,0
11-10-2020,715,0,0,4,2115,400,0,0
11/25/2020,113,0,0,3,2114,419,0,0
09/23/2020,712,0,0,4,2116,500,0,0
08/13/2020,522,0,0,6,2127,400,0,0
08-04-2020,745,0,0,9,2119,400,0,0
09-06-2020,743,0,0,11,2135,419,0,0
07-03-2020,711,0,0,11,2135,900,0,0
12-02-2020,652,0,0,8,2124,419,0,0
12/18/2020,553,0,0,1,2128,962,0,0
09-04-2020,715,0,0,6,2125,429,0,0
07/22/2020,555,0,0,1,2128,429,0,0
09/30/2020,621,0,0,11,2134,960,0,0
12-12-2020,714,0,0,7,2122,419,0,0
10-02-2020,554,0,0,11,2135,900,0,0
11/21/2020,142,0,0,12,2132,931,0,0
09-07-2020,745,0,0,4,2215,460,0,0
07/20/2020,113,0,0,7,2121,429,0,0
09/26/2020,600,0,0,8,2124,429,0,0
08-11-2020,553,0,0,7,2124,419,0,0
10/13/2020,444,0,0,7,2122,960,0,0
08/17/2020,733,0,0,1,2128,429,0,0
07/27/2020,113,0,0,11,2135,429,0,0
12/22/2020,412,0,0,8,2126,900,0,0
11-01-2020,745,0,0,8,2124,429,0,0
07/30/2020,553,0,0,9,2119,429,0,0
11/28/2020,553,0,0,7,2119,322,0,0
12/14/2020,745,0,0,3,2129,429,0,0
10/20/2020,553,0,0,6,2118,962,0,0
09-08-2020,553,0,0,3,2108,900,0,0
09-04-2020,553,0,0,1,2128,900,0,0
08-01-2020,745,0,0,7,2121,429,0,0
11-08-2020,522,0,0,9,2119,429,0,0
10-07-2020,500,0,0,12,2132,900,0,0
07-10-2020,745,0,0,9,2115,439,0,0
08-03-2020,553,0,0,8,2126,419,0,0
08/14/2020,740,0,0,7,2125,241,0,0
09/23/2020,714,0,0,9,2130,439,0,0
07/28/2020,733,0,0,7,2122,429,0,0
10/27/2020,151,0,0,7,2119,900,0,0
08-11-2020,733,0,0,4,2115,429,0,0
08/23/2020,735,0,0,8,2126,429,0,0
10/22/2020,735,0,0,9,2119,400,0,0
12/31/2020,714,0,0,8,2126,400,0,0
11/27/2020,553,0,0,6,2127,960,0,0
08/20/2020,553,0,0,1,2128,400,0,0
11-10-2020,600,0,0,4,2116,963,0,0
09-09-2020,711,0,0,4,2118,963,0,0
08/27/2020,712,0,0,4,2116,429,0,0
11/30/2020,553,0,0,11,2135,965,0,0
10/15/2020,611,0,0,12,2132,400,0,0
10-09-2020,553,0,0,1,2128,400,0,0
11/30/2020,553,0,0,12,2132,965,0,0
12/14/2020,554,0,0,12,2131,429,0,0
07/15/2020,745,0,0,8,2126,500,0,0
10-03-2020,651,0,0,9,2130,963,0,0
09/21/2020,554,0,0,12,2132,419,0,0
10/15/2020,113,0,0,9,2115,460,0,0
11/23/2020,745,0,0,7,2121,419,0,0
11/18/2020,714,0,0,4,2111,500,0,0
09-04-2020,411,0,0,4,2111,961,0,0
12/31/2020,553,0,0,3,2111,960,0,0
10/22/2020,553,0,0,4,2116,460,0,0
08-04-2020,813,0,0,7,2122,900,0,0
09/18/2020,715,0,0,8,2126,400,0,0
08-02-2020,715,0,0,11,2135,419,0,0
09/23/2020,735,0,0,4,2116,429,0,0
10/14/2020,600,0,0,7,2122,960,0,0
11/19/2020,743,0,0,3,2129,419,0,0
07/24/2020,400,0,0,9,2121,429,0,0
12/26/2020,500,0,0,9,2130,900,0,0
07/31/2020,511,0,0,11,2134,429,0,0
12-09-2020,743,0,0,11,2135,400,0,0
08/14/2020,714,0,0,3,2113,500,0,0
07/24/2020,652,0,0,12,2132,429,0,0
12/22/2020,554,0,0,3,2113,429,0,0
12/25/2020,113,0,0,8,2122,400,0,0
10-07-2020,735,0,0,7,2121,429,0,0
10/28/2020,710,0,0,6,2127,429,0,0
12-04-2020,600,0,0,4,2116,900,0,0
12-10-2020,131,0,0,4,2118,961,0,0
08/30/2020,553,0,0,7,2119,900,0,0
07-06-2020,712,0,0,6,2125,429,0,0
07/13/2020,553,0,0,9,2121,400,0,0
10/23/2020,553,0,0,4,2111,900,0,0
08/24/2020,743,0,0,11,2135,400,0,0
09/30/2020,113,0,0,4,2118,161,0,0
09-05-2020,730,0,0,9,2130,311,0,0
09/13/2020,735,0,0,9,2121,429,0,0
10/13/2020,712,0,0,8,2126,963,0,0
07-08-2020,745,0,0,4,2118,500,0,0
07/13/2020,553,0,0,3,2114,439,0,0
08/21/2020,553,0,0,3,2109,900,0,0
07/22/2020,712,0,0,3,2129,500,0,0
08-03-2020,745,0,0,7,2119,569,0,0
11/30/2020,651,0,0,11,2134,429,0,0
09/21/2020,712,0,0,7,2125,900,0,0
09/29/2020,552,0,0,4,2115,429,0,0
09-11-2020,553,0,0,7,2130,429,0,0
08/29/2020,600,0,0,6,2119,963,0,0
11/23/2020,743,0,0,11,2135,429,0,0
12/13/2020,700,0,0,9,2119,960,0,0
08/30/2020,600,0,0,4,2215,900,0,0
08-01-2020,733,0,0,11,2134,429,0,0
09/28/2020,745,0,0,3,2108,400,0,0
12-08-2020,743,0,0,9,2119,400,0,0
11/24/2020,743,0,0,3,2129,429,0,0
10-07-2020,553,0,0,9,2130,960,0,0
12/25/2020,736,0,0,11,2135,429,0,0
11-05-2020,641,0,0,8,2124,429,0,0
10/19/2020,113,0,0,11,2135,400,0,0
11/30/2020,600,0,0,4,2118,900,0,0
11/30/2020,553,0,0,7,2122,429,0,0
09-09-2020,714,0,0,4,2116,500,0,0
08/22/2020,746,0,0,8,2124,429,0,0
09/13/2020,735,0,0,9,2121,419,0,0
07/30/2020,735,0,0,11,2467,500,0,0
10/20/2020,715,0,0,9,2130,419,0,0
08/25/2020,553,0,0,8,2124,900,0,0
09/25/2020,553,0,0,7,2121,429,0,0
07-11-2020,553,0,0,7,2119,900,0,0
10-04-2020,551,0,0,12,2132,400,0,0
10/20/2020,715,0,0,7,2118,300,0,0
09-03-2020,733,0,0,12,2130,174,0,0
09/20/2020,711,0,0,11,2134,960,0,0
08/30/2020,151,0,0,8,2124,965,0,0
09/28/2020,553,0,0,7,2119,965,0,0
11/21/2020,743,0,0,7,2125,162,0,0
09/14/2020,553,0,0,1,2128,962,0,0
12-12-2020,400,0,0,9,2121,429,0,0
08/26/2020,731,0,0,7,2122,131,0,0
10-11-2020,715,0,0,3,2114,429,0,0
08-07-2020,745,0,0,3,2111,599,0,0
09/23/2020,600,0,0,7,2125,900,0,0
10-07-2020,743,0,0,12,2136,519,0,0
11/27/2020,554,0,0,11,2135,400,0,0
12/17/2020,113,0,0,12,2131,429,0,0
10-05-2020,552,0,0,3,2113,960,0,0
10/23/2020,553,0,0,4,2199,900,0,0
10/25/2020,552,0,0,1,2128,960,0,0
08/31/2020,553,0,0,7,2119,500,0,0
11/30/2020,444,0,0,12,2136,960,0,0
10/16/2020,600,0,0,4,2116,900,0,0
11/24/2020,600,0,0,7,2125,900,0,0
11/15/2020,600,0,0,3,2114,960,0,0
08/28/2020,553,0,0,9,2119,962,0,0
11/30/2020,714,0,0,8,2126,311,0,0
08-03-2020,600,0,0,6,2127,429,0,0
07-02-2020,714,0,0,4,2116,922,0,0
08-03-2020,553,0,0,6,2127,419,0,0
09/23/2020,554,0,0,11,2135,429,0,0
08-03-2020,143,0,0,8,2124,936,0,0
10/27/2020,743,0,0,6,2127,429,0,0
08-04-2020,553,0,0,9,2130,900,0,0
12/13/2020,553,0,0,3,2114,960,0,0
08/20/2020,745,0,0,7,2121,429,0,0
07-02-2020,733,0,0,8,2124,429,0,0
10-09-2020,600,0,0,6,2118,900,0,0
12/23/2020,511,0,0,12,2132,419,0,0
11/28/2020,743,0,0,6,2118,300,0,0
12-01-2020,600,0,0,4,2115,961,0,0
12/14/2020,714,0,0,1,2128,341,0,0
12-05-2020,553,0,0,4,2118,400,0,0
10/22/2020,553,0,0,12,2131,900,0,0
12/14/2020,745,0,0,6,2127,449,0,0
10/23/2020,150,0,0,1,2128,960,0,0
11-10-2020,600,0,0,7,2125,963,0,0
10/27/2020,113,0,0,8,2124,459,0,0
12-02-2020,650,0,0,3,2114,419,0,0
09-08-2020,735,0,0,12,2136,429,0,0
07/17/2020,600,0,0,3,2114,940,0,0
08-08-2020,736,0,0,9,2131,400,0,0
10-03-2020,735,0,0,4,2115,429,0,0
09-05-2020,745,0,0,3,2129,419,0,0
08-01-2020,746,0,0,12,2131,419,0,0
08/31/2020,553,0,0,9,2119,400,0,0
10/21/2020,553,0,0,9,2119,400,0,0
12/24/2020,511,0,0,12,2136,965,0,0
08/30/2020,550,0,0,9,2132,962,0,0
09/18/2020,113,0,0,8,2124,400,0,0
10-06-2020,111,0,0,7,2125,241,0,0
07-01-2020,714,0,0,12,2136,400,0,0
10/19/2020,422,0,0,4,2118,241,0,0
09/18/2020,714,0,0,3,2113,439,0,0
12/15/2020,743,0,0,4,2111,460,0,0
09/25/2020,553,0,0,12,2132,419,0,0
11/20/2020,712,0,0,4,2118,880,0,0
10/24/2020,531,0,0,11,2134,429,0,0
10/27/2020,600,0,0,7,2125,429,0,0
07-02-2020,715,0,0,3,2108,429,0,0
10-11-2020,714,0,0,4,2118,400,0,0
07-03-2020,413,0,0,11,2135,960,0,0
08/28/2020,111,0,0,9,2119,429,0,0
09/30/2020,733,0,0,9,2130,130,0,0
08/29/2020,553,0,0,7,2125,429,0,0
10/29/2020,553,0,0,4,2118,960,0,0
09-05-2020,552,0,0,3,2113,100,0,0
10/19/2020,743,0,0,3,2113,429,0,0
09-02-2020,733,0,0,4,2115,400,0,0
09/28/2020,553,0,0,7,2119,429,0,0
07/19/2020,411,0,0,7,2125,960,0,0
07-09-2020,113,0,0,8,2126,429,0,0
08/28/2020,745,0,0,3,2114,882,0,0
08/22/2020,746,0,0,3,2113,429,0,0
10/26/2020,113,0,0,6,2127,429,0,0
12/20/2020,550,0,0,6,2127,429,0,0
09/29/2020,714,0,0,4,2215,400,0,0
09/19/2020,711,0,0,4,2115,900,0,0
08/20/2020,553,0,0,3,2113,400,0,0
09/24/2020,641,0,0,3,2114,500,0,0
09/23/2020,554,0,0,11,2135,429,0,0
11/20/2020,745,0,0,8,2124,429,0,0
10/27/2020,743,0,0,8,2126,400,0,0
11/16/2020,745,0,0,3,2129,500,0,0
09-02-2020,740,0,0,6,2127,952,0,0
10/25/2020,733,0,0,4,2215,400,0,0
12-04-2020,611,0,0,9,2130,965,0,0
08-09-2020,652,0,0,9,2130,963,0,0
08/15/2020,600,0,0,11,2134,963,0,0
12/28/2020,735,0,0,12,2131,429,0,0
10/21/2020,743,0,0,9,2119,429,0,0
10/23/2020,653,0,0,6,2127,900,0,0
08/25/2020,600,0,0,4,2118,429,0,0
09/26/2020,553,0,0,4,2118,960,0,0
09/30/2020,553,0,0,3,2129,900,0,0
09/23/2020,113,0,0,4,2115,429,0,0
08-04-2020,733,0,0,8,2124,429,0,0
08/21/2020,553,0,0,6,2127,900,0,0
07-10-2020,745,0,0,1,2128,500,0,0
12/30/2020,700,0,0,1,2128,429,0,0
11/27/2020,551,0,0,12,2132,965,0,0
11/20/2020,715,0,0,9,2130,400,0,0
07/24/2020,600,0,0,4,2118,900,0,0
10-07-2020,553,0,0,6,2118,900,0,0
12/14/2020,553,0,0,3,2108,211,0,0
10/30/2020,424,0,0,9,2119,211,0,0
10/18/2020,113,0,0,6,2127,429,0,0
11/15/2020,745,0,0,9,2121,429,0,0
07/14/2020,600,0,0,8,2126,419,0,0
07-07-2020,442,0,0,6,2127,500,0,0
08/28/2020,600,0,0,7,2125,962,0,0
07-05-2020,113,0,0,9,2130,400,0,0
11/17/2020,554,0,0,8,2124,419,0,0
08/27/2020,551,0,0,12,2131,400,0,0
11-09-2020,553,0,0,7,2121,900,0,0
07/21/2020,551,0,0,6,2127,938,0,0
12-06-2020,744,0,0,9,2119,429,0,0
07/25/2020,743,0,0,9,2215,449,0,0
12/28/2020,550,0,0,3,2109,882,0,0
10/25/2020,113,0,0,9,2120,460,0,0
12/18/2020,553,0,0,6,2127,429,0,0
11-03-2020,550,0,0,12,2132,900,0,0
08-12-2020,553,0,0,3,2114,331,0,0
11-09-2020,151,0,0,12,2132,938,0,0
08-07-2020,553,0,0,7,2121,419,0,0
09-12-2020,445,0,0,9,2130,963,0,0
08-11-2020,700,0,0,3,2114,340,0,0
10-07-2020,552,0,0,8,2122,900,0,0
07/18/2020,746,0,0,6,2210,449,0,0
08/29/2020,736,0,0,4,2116,419,0,0
11/17/2020,500,0,0,8,2126,429,0,0
09/17/2020,711,0,0,4,2118,960,0,0
10/20/2020,554,0,0,8,2126,429,0,0
12/22/2020,424,0,0,7,2119,400,0,0
12-10-2020,552,0,0,4,2111,965,0,0
11/29/2020,745,0,0,9,2130,419,0,0
07-02-2020,551,0,0,3,2129,429,0,0
12/19/2020,730,0,0,7,2122,429,0,0
11-09-2020,712,0,0,11,2135,400,0,0
08/15/2020,743,0,0,11,2135,429,0,0
11-07-2020,113,0,0,8,2124,400,0,0
09-02-2020,118,0,0,4,2215,400,0,0
07/23/2020,743,0,0,4,2118,400,0,0
09-02-2020,735,0,0,9,2215,500,0,0
11/29/2020,118,0,0,4,2116,429,0,0
08/28/2020,400,0,0,7,2125,429,0,0
08/31/2020,411,0,0,1,2128,898,0,0
08/19/2020,113,0,0,7,2122,429,0,0
07-01-2020,600,0,0,9,2115,900,0,0
11/25/2020,113,0,0,1,2128,419,0,0
08-10-2020,600,0,0,8,2126,900,0,0
11/27/2020,714,0,0,12,2131,429,0,0
08/14/2020,600,0,0,4,2118,962,0,0
09/16/2020,553,0,0,7,2121,900,0,0
10-06-2020,113,0,0,12,2136,429,0,0
09-04-2020,552,0,0,12,2136,888,0,0
07/21/2020,712,0,0,4,2118,331,0,0
12/27/2020,554,0,0,1,2128,400,0,0
11-04-2020,553,0,0,7,2119,900,0,0
10-07-2020,813,0,0,12,2136,419,0,0
12/26/2020,555,0,0,3,2109,174,0,0
07/22/2020,522,0,0,4,2115,400,0,0
09/30/2020,553,0,0,7,2119,900,0,0
07-02-2020,743,0,0,11,2135,459,0,0
12-03-2020,554,0,0,1,2128,400,0,0
11-03-2020,442,0,0,1,2128,300,0,0
08/17/2020,746,0,0,11,2135,419,0,0
08-11-2020,553,0,0,12,2130,962,0,0
12-02-2020,714,0,0,7,2119,429,0,0
07-05-2020,553,0,0,4,2118,429,0,0
12-01-2020,714,0,0,11,2135,599,0,0
07-01-2020,652,0,0,6,2210,400,0,0
11/16/2020,735,0,0,9,2130,400,0,0
10/21/2020,745,0,0,4,2116,500,0,0
07/17/2020,113,0,0,8,2126,429,0,0
12/31/2020,500,0,0,12,2131,400,0,0
10/31/2020,652,0,0,7,2121,500,0,0
10-10-2020,553,0,0,9,2130,400,0,0
10/25/2020,622,0,0,1,2128,400,0,0
11-01-2020,553,0,0,6,2127,400,0,0
12/22/2020,511,0,0,11,2134,965,0,0
07/20/2020,553,0,0,8,2126,419,0,0
08/17/2020,553,0,0,3,2108,900,0,0
07/20/2020,142,0,0,6,2210,900,0,0
08-04-2020,444,0,0,8,2124,960,0,0
10/28/2020,553,0,0,4,2118,960,0,0
08-02-2020,745,0,0,3,2109,161,0,0
07/23/2020,712,0,0,6,2118,300,0,0
11/27/2020,736,0,0,9,2121,419,0,0
09-12-2020,743,0,0,9,2119,429,0,0
09/23/2020,553,0,0,9,2130,400,0,0
08-04-2020,730,0,0,11,2135,400,0,0
10/19/2020,551,0,0,7,2124,419,0,0
12/20/2020,445,0,0,9,2119,429,0,0
10/30/2020,553,0,0,4,2116,900,0,0
11/13/2020,733,0,0,3,2109,599,0,0
10/16/2020,714,0,0,9,2130,419,0,0
11/29/2020,553,0,0,7,2125,962,0,0
11-05-2020,733,0,0,9,2119,400,0,0
11-06-2020,735,0,0,9,2119,400,0,0
07-09-2020,131,0,0,9,2130,960,0,0
08-04-2020,745,0,0,12,2130,429,0,0
10/23/2020,745,0,0,4,2215,460,0,0
07/21/2020,735,0,0,9,2130,311,0,0
08-04-2020,553,0,0,12,2130,419,0,0
09-11-2020,113,0,0,4,2215,429,0,0
09/28/2020,735,0,0,12,2131,429,0,0
10-08-2020,622,0,0,8,2124,429,0,0
12/25/2020,444,0,0,8,2124,900,0,0
11-05-2020,611,0,0,11,2215,429,0,0
12/24/2020,400,0,0,7,2118,962,0,0
07/18/2020,714,0,0,8,2122,161,0,0
10/13/2020,733,0,0,4,2118,400,0,0
12/21/2020,743,0,0,3,2108,500,0,0
11-12-2020,743,0,0,8,2124,331,0,0
08-10-2020,600,0,0,4,2118,960,0,0
10-10-2020,550,0,0,4,2215,400,0,0
09/28/2020,745,0,0,9,2121,429,0,0
09-01-2020,743,0,0,11,2135,400,0,0
10-07-2020,553,0,0,8,2126,900,0,0
08/28/2020,745,0,0,4,2215,400,0,0
12-02-2020,745,0,0,7,2121,429,0,0
09/20/2020,745,0,0,9,2130,300,0,0
07-04-2020,553,0,0,7,2125,960,0,0
08/25/2020,500,0,0,4,2116,429,0,0
08-07-2020,553,0,0,3,2129,419,0,0
07/17/2020,553,0,0,3,2129,429,0,0
09/19/2020,651,0,0,4,2118,429,0,0
10/31/2020,400,0,0,12,2132,961,0,0
10/30/2020,733,0,0,9,2119,429,0,0
09/14/2020,745,0,0,8,2124,429,0,0
08-09-2020,531,0,0,3,2110,960,0,0
09/23/2020,745,0,0,9,2121,429,0,0
07-06-2020,412,0,0,7,2122,962,0,0
12-10-2020,600,0,0,9,2115,900,0,0
07/26/2020,745,0,0,7,2124,500,0,0
08/19/2020,553,0,0,6,2127,429,0,0
11/22/2020,740,0,0,4,2116,500,0,0
09-07-2020,400,0,0,11,2135,429,0,0
09-03-2020,733,0,0,7,2125,592,0,0
10-09-2020,600,0,0,4,2116,174,0,0
11/29/2020,600,0,0,6,2125,900,0,0
08/27/2020,671,0,0,4,2118,962,0,0
12/14/2020,553,0,0,7,2125,100,0,0
08/27/2020,715,0,0,9,2130,429,0,0
11/24/2020,113,0,0,3,2114,400,0,0
08-01-2020,511,0,0,9,2130,429,0,0
11/13/2020,641,0,0,3,2116,960,0,0
09/24/2020,500,0,0,12,2131,960,0,0
10-05-2020,422,0,0,11,2467,241,0,0
11-01-2020,424,0,0,4,2118,429,0,0
08-06-2020,731,0,0,12,2136,839,0,0
08/19/2020,553,0,0,4,2118,400,0,0
10-11-2020,553,0,0,12,2131,400,0,0
10/16/2020,714,0,0,4,2215,429,0,0
09-03-2020,652,0,0,6,2210,400,0,0
07-07-2020,113,0,0,9,2119,400,0,0
08-10-2020,714,0,0,11,2135,419,0,0
11-04-2020,553,0,0,1,2128,429,0,0
08/13/2020,744,0,0,7,2118,429,0,0
11-05-2020,118,0,100,8,2126,429,100,0
11/22/2020,554,0,0,11,2135,400,0,0
11-01-2020,551,0,0,6,2210,519,0,0
11-03-2020,553,0,0,9,2131,419,0,0
07/22/2020,733,0,0,1,2128,116,0,0
12/24/2020,511,0,0,7,2121,960,0,0
09/14/2020,553,0,0,9,2119,900,0,0
10-10-2020,551,0,0,3,2109,941,0,0
11-03-2020,745,0,0,3,2108,400,0,0
08/21/2020,553,0,0,1,2128,962,0,0
07/31/2020,113,0,0,9,2130,888,0,0
09/28/2020,714,0,0,3,2114,400,0,0
12-01-2020,600,0,0,4,2118,429,0,0
12/26/2020,735,0,0,3,2110,599,0,0
11/25/2020,733,0,0,9,2130,429,0,0
09-09-2020,743,0,0,9,2121,419,0,0
10-06-2020,412,0,0,12,2130,962,0,0
12-08-2020,745,0,0,4,2116,981,0,0
07-10-2020,743,0,0,11,2135,429,0,0
07/14/2020,554,0,0,9,2132,419,0,0
11-04-2020,113,0,0,12,2131,419,0,0
08-11-2020,700,0,0,7,2121,429,0,0
10/19/2020,554,0,0,6,2127,429,0,0
08/22/2020,553,0,0,6,2127,937,0,0
08/28/2020,743,0,0,11,2135,429,0,0
07/28/2020,600,0,0,8,2126,962,0,0
07/25/2020,746,0,0,4,2115,429,0,0
12/13/2020,553,0,0,3,2109,962,0,0
07-05-2020,553,0,0,3,2111,429,0,0
11/18/2020,713,0,0,12,2136,460,0,0
09/18/2020,151,0,0,7,2125,429,0,0
10-06-2020,741,0,0,4,2215,429,0,0
10/28/2020,745,0,0,1,2128,700,0,0
09/25/2020,735,0,0,12,2136,419,0,0
11-06-2020,743,0,0,3,2114,460,0,0
07/17/2020,553,0,0,8,2126,419,0,0
08-11-2020,714,0,0,7,2125,429,0,0
07-10-2020,745,0,0,7,2125,419,0,0
11-09-2020,553,0,0,7,2119,960,0,0
09-10-2020,745,0,0,8,2126,429,0,0
07-11-2020,741,0,0,6,2210,599,0,0
09-12-2020,745,0,0,7,2122,400,0,0
08/16/2020,553,0,0,6,2127,900,0,0
08/31/2020,511,0,0,3,2108,400,0,0
12/29/2020,746,0,0,6,2127,429,0,0
09/21/2020,714,0,0,1,2128,429,0,0
07/21/2020,553,0,0,3,2129,400,0,0
10/28/2020,735,0,0,7,2121,429,0,0
10/30/2020,600,0,0,11,2135,429,0,0
08-04-2020,553,0,0,9,2130,960,0,0
09/22/2020,715,0,0,6,2127,429,0,0
08/14/2020,553,0,0,7,2122,962,0,0
11-06-2020,712,0,0,9,2119,400,0,0
10/28/2020,715,0,0,12,2132,962,0,0
12-09-2020,442,0,0,4,2215,429,0,0
07/15/2020,745,0,0,6,2125,449,0,0
12/26/2020,553,0,0,3,2114,174,0,0
12-03-2020,745,0,0,3,2111,599,0,0
10/21/2020,600,0,0,1,2128,123,0,0
09/16/2020,743,0,0,3,2129,400,0,0
08/14/2020,600,0,0,3,2114,900,0,0
09/25/2020,714,0,0,6,2127,114,0,0
12/23/2020,522,0,0,8,2126,429,0,0
08/26/2020,553,0,0,7,2121,311,0,0
09/26/2020,700,0,0,1,2128,972,0,0
07/13/2020,440,0,0,8,2124,900,0,0
10/24/2020,733,0,0,6,2127,429,0,0
10/28/2020,554,0,0,7,2121,429,0,0
10-06-2020,745,0,0,4,2111,429,0,0
08-02-2020,424,0,0,7,2122,429,0,0
07/16/2020,735,0,0,6,2127,419,0,0
09-11-2020,510,0,0,8,2124,419,0,0
11-04-2020,551,0,0,7,2118,429,0,0
09/13/2020,714,0,0,4,2215,439,0,0
12/21/2020,745,0,0,9,2130,160,0,0
09-10-2020,553,0,0,4,2118,960,0,0
10/26/2020,553,0,0,4,2118,900,0,0
10/15/2020,554,0,0,8,2126,419,0,0
07/14/2020,113,0,0,8,2124,429,0,0
07-05-2020,600,0,0,4,2118,900,0,0
08/21/2020,745,0,0,3,2108,419,0,0
07/24/2020,735,0,0,4,2116,500,0,0
08/30/2020,113,0,0,11,2134,429,0,0
11-08-2020,600,0,0,3,2111,963,0,0
09/16/2020,743,0,0,6,2127,429,0,0
07-02-2020,553,0,0,6,2127,962,0,0
11/15/2020,424,0,0,3,2113,429,0,0
09-08-2020,113,10,10,4,2215,400,20,0
11/16/2020,522,0,0,4,2118,400,0,0
11/13/2020,745,0,0,7,2121,429,0,0
10-07-2020,711,0,0,11,2134,963,0,0
11/17/2020,500,0,0,1,2128,962,0,0
10/28/2020,743,0,0,3,2109,429,0,0
10-12-2020,714,0,0,3,2113,429,0,0
08/28/2020,113,0,0,8,2124,429,0,0
10/22/2020,745,0,0,4,2115,400,0,0
08-06-2020,714,0,0,3,2108,500,0,0
12/28/2020,743,0,0,6,2127,400,0,0
07/23/2020,444,0,0,8,2124,962,0,0
11-02-2020,412,0,0,8,2124,962,0,0
07-05-2020,113,0,0,8,2126,429,0,0
07/16/2020,552,0,0,6,2125,519,0,0
10-11-2020,621,0,0,4,2118,960,0,0
09/30/2020,900,300,0,8,2124,962,300,0
11/20/2020,400,0,0,9,2130,419,0,0
08/19/2020,745,0,0,11,2135,519,0,0
10-09-2020,743,0,0,12,2131,549,0,0
10/17/2020,711,0,0,7,2119,962,0,0
10-02-2020,553,0,0,9,2131,400,0,0
11/19/2020,600,0,0,11,2215,340,0,0
09-06-2020,600,0,0,4,2118,900,0,0
07-11-2020,440,0,0,9,2121,429,0,0
09/14/2020,553,0,0,11,2135,419,0,0
08/26/2020,733,0,0,1,2128,429,0,0
11-09-2020,714,0,0,9,2120,429,0,0
09-11-2020,444,0,0,8,2126,900,0,0
09-05-2020,553,0,0,12,2126,900,0,0
11/23/2020,554,0,0,11,2135,429,0,0
07/19/2020,714,0,0,9,2132,311,0,0
09/23/2020,554,0,0,8,2126,429,0,0
09-12-2020,553,0,0,11,2135,419,0,0
07-12-2020,553,0,0,9,2119,429,0,0
09/26/2020,553,0,0,12,2131,419,0,0
09/16/2020,553,0,0,9,2121,960,0,0
08/26/2020,143,0,0,8,2122,340,0,0
09/22/2020,424,0,0,3,2109,311,0,0
11-06-2020,553,0,0,11,2135,962,0,0
07-11-2020,735,0,0,9,2130,400,0,0
07/18/2020,553,0,0,3,2129,400,0,0
11/19/2020,745,0,0,3,2110,951,0,0
10/31/2020,552,0,0,9,2120,900,0,0
09-11-2020,743,0,0,12,2132,331,0,0
09-02-2020,553,0,0,9,2120,900,0,0
10/17/2020,113,0,0,4,2215,460,0,0
11-03-2020,554,0,0,4,2118,419,0,0
12/17/2020,553,0,0,6,2127,400,0,0
10/31/2020,553,0,0,9,2119,965,0,0
11/25/2020,711,0,0,4,2118,900,0,0
11/15/2020,553,0,0,8,2124,429,0,0
08-12-2020,735,0,0,3,2129,400,0,0
07/23/2020,553,0,0,3,2129,921,0,0
07/24/2020,600,0,0,7,2119,900,0,0
10/31/2020,553,0,0,9,2119,400,0,0
11/14/2020,511,0,0,11,2135,400,0,0
12/17/2020,553,0,0,12,2136,419,0,0
10/26/2020,600,0,0,11,2134,419,0,0
12/17/2020,715,0,0,8,2122,429,0,0
07/13/2020,743,0,0,7,2125,429,0,0
11/14/2020,550,0,0,8,2122,419,0,0
08/31/2020,113,0,0,9,2121,429,0,0
07/22/2020,743,0,0,1,2128,213,0,0
08/13/2020,552,0,0,4,2118,960,0,0
12/27/2020,553,0,0,11,2134,429,0,0
10/29/2020,745,0,0,3,2111,599,0,0
12-01-2020,714,0,0,4,2118,400,0,0
07-08-2020,714,0,0,4,2118,400,0,0
07/20/2020,712,0,0,3,2111,922,0,0
07-03-2020,733,0,0,8,2126,419,0,0
11/22/2020,743,0,0,3,2111,429,0,0
09/13/2020,745,0,0,9,2120,429,0,0
08/28/2020,117,0,0,6,2210,449,0,0
07/27/2020,411,0,0,9,2131,962,0,0
09/28/2020,746,0,0,1,2128,419,0,0
12/28/2020,743,0,0,6,2127,519,0,0
12-06-2020,733,0,0,4,2215,419,0,0
09/23/2020,733,0,0,11,2135,400,0,0
07-05-2020,500,0,0,12,2132,311,0,0
11/25/2020,553,0,0,7,2119,900,0,0
07-11-2020,553,0,0,9,2119,900,0,0
07/27/2020,400,0,0,8,2126,962,0,0
12/18/2020,745,0,0,7,2121,213,0,0
10/29/2020,552,0,0,12,2136,429,0,0
07/21/2020,736,0,0,9,2130,400,0,0
11-03-2020,735,0,0,8,2124,419,0,0
07/18/2020,745,0,0,4,2215,400,0,0
07-11-2020,600,0,0,7,2125,900,0,0
10-02-2020,600,0,0,3,2129,900,0,0
12-10-2020,714,0,0,4,2215,500,0,0
11/28/2020,553,0,0,9,2121,960,0,0
07-12-2020,700,0,0,1,2128,429,0,0
12-04-2020,552,0,0,6,2125,900,0,0
11-03-2020,743,0,0,6,2118,644,0,0
10-08-2020,554,0,0,4,2118,429,0,0
12/20/2020,553,0,0,7,2125,439,0,0
09-12-2020,611,0,0,4,2116,599,0,0
09/23/2020,553,0,0,7,2121,962,0,0
10/15/2020,741,0,0,9,2119,151,0,0
08/31/2020,113,0,0,7,2119,429,0,0
12-02-2020,412,0,0,11,2135,400,0,0
09/30/2020,113,0,50,8,2126,429,50,0
08/18/2020,735,0,0,3,2110,599,0,0
07/30/2020,600,0,0,11,2135,429,0,0
11-05-2020,743,0,0,12,2136,419,0,0
08-03-2020,730,0,0,6,2125,429,0,0
10/20/2020,712,0,0,7,2122,429,0,0
12-05-2020,444,0,0,1,2128,400,0,0
10-02-2020,743,0,0,9,2115,429,0,0
10/18/2020,651,0,0,12,2131,419,0,0
10/22/2020,553,0,0,11,2134,963,0,0
10-05-2020,554,0,0,12,2136,419,0,0
11/19/2020,743,0,0,9,2130,161,0,0
12-10-2020,714,0,0,4,2116,500,0,0
08/13/2020,743,0,0,11,2135,429,0,0
12/14/2020,745,0,0,4,2215,241,0,0
12/14/2020,714,0,0,4,2116,429,0,0
09/24/2020,740,0,0,1,2128,962,0,0
07/29/2020,554,0,0,12,2131,429,0,0
07-04-2020,651,0,0,12,2131,419,0,0
11/25/2020,611,0,0,4,2116,429,0,0
08-03-2020,553,0,0,4,2120,882,0,0
08-09-2020,113,0,0,6,2125,429,0,0
08-06-2020,551,0,0,9,2121,400,0,0
12/27/2020,522,0,0,11,2134,429,0,0
07/18/2020,714,0,0,3,2114,429,0,0
11/29/2020,142,0,0,7,2122,900,0,0
09/23/2020,553,0,0,4,2115,429,0,0
07/15/2020,553,0,0,3,2111,500,0,0
07/19/2020,745,0,0,11,2134,429,0,0
08/22/2020,553,0,0,1,2128,963,0,0
11/28/2020,735,0,0,8,2126,254,0,0
08-11-2020,553,0,0,9,2131,400,0,0
11/23/2020,745,0,0,3,2110,599,0,0
10/20/2020,553,0,0,4,2118,960,0,0
07-07-2020,600,0,0,1,2128,962,0,0
10/27/2020,733,0,0,4,2120,400,0,0
07/24/2020,741,0,0,3,2113,400,0,0
10-12-2020,743,0,0,4,2115,429,0,0
08/14/2020,553,0,0,7,2119,900,0,0
12/15/2020,735,0,0,6,2127,419,0,0
07/21/2020,740,0,0,1,2128,559,0,0
12-01-2020,113,0,0,11,2135,429,0,0
08-11-2020,743,0,0,11,2134,800,0,0
11/26/2020,735,0,0,4,2111,519,0,0
11/30/2020,735,0,0,3,2110,599,0,0
08-01-2020,711,0,0,9,2119,900,0,0
11-09-2020,733,0,0,7,2125,429,0,0
11-10-2020,553,0,0,9,2120,900,0,0
12-02-2020,500,0,0,11,2135,419,0,0
11/14/2020,511,0,0,6,2127,429,0,0
09/16/2020,711,0,0,7,2125,960,0,0
10/29/2020,600,0,0,4,2116,429,0,0
08/31/2020,745,0,0,11,2135,400,0,0
09/16/2020,743,0,0,9,2115,429,0,0
12/25/2020,113,0,0,8,2126,429,0,0
08-12-2020,731,0,0,3,2129,880,0,0
08-09-2020,745,0,0,7,2125,429,0,0
08/25/2020,424,0,0,11,2135,400,0,0
08/19/2020,743,0,0,11,2135,160,0,0
08-07-2020,745,0,0,7,2121,215,0,0
11/14/2020,500,0,0,11,2135,400,0,0
08/27/2020,746,0,0,7,2125,419,0,0
07-04-2020,554,0,0,7,2125,429,0,0
07-04-2020,553,0,0,12,2132,419,0,0
08/16/2020,552,0,0,6,2127,962,0,0
11/20/2020,743,0,0,1,2128,429,0,0
12/31/2020,113,0,0,7,2119,429,0,0
10/28/2020,554,0,0,11,2135,429,0,0
10-04-2020,735,0,0,11,2134,429,0,0
10/27/2020,522,0,0,3,2108,400,0,0
11-09-2020,743,0,0,9,2120,215,0,0
12/17/2020,553,0,0,11,2134,963,0,0
09/22/2020,735,0,0,12,2136,891,0,0
10/13/2020,735,0,0,3,2113,429,0,0
10/16/2020,712,0,0,4,2199,882,0,0
09/18/2020,553,0,0,7,2119,400,0,0
09/17/2020,553,0,0,4,2215,900,0,0
09-07-2020,151,0,0,7,2121,900,0,0
08/28/2020,553,0,0,8,2124,429,0,0
09/24/2020,714,0,0,9,2120,429,0,0
09-03-2020,733,0,0,9,2130,419,0,0
10/17/2020,522,0,0,4,2118,429,0,0
12/16/2020,113,0,0,9,2119,400,0,0
07-09-2020,743,0,0,8,2124,419,0,0
07-03-2020,113,0,0,4,2115,400,0,0
09/21/2020,611,0,0,4,2115,400,0,0
10/26/2020,743,0,0,4,2120,174,0,0
09/21/2020,600,0,0,11,2134,963,0,0
12-12-2020,711,0,0,3,2108,500,0,0
11-05-2020,735,0,0,9,2130,400,0,0
11-04-2020,735,0,0,9,2119,429,0,0
12/17/2020,553,0,0,4,2118,429,0,0
12-11-2020,553,0,0,8,2124,429,0,0
08/15/2020,715,0,0,8,2122,429,0,0
07/14/2020,600,0,0,12,2131,460,0,0
07/26/2020,714,0,0,7,2121,429,0,0
07-02-2020,611,0,0,3,2108,900,0,0
09-08-2020,743,0,0,1,2128,429,0,0
07-04-2020,553,0,0,4,2115,439,0,0
10/22/2020,745,0,0,11,2134,519,0,0
08/16/2020,522,0,0,4,2115,400,0,0
09/27/2020,552,0,0,6,2127,960,0,0
09-12-2020,741,0,0,9,2115,331,0,0
08-03-2020,552,0,0,8,2124,962,0,0
09/18/2020,113,5,5,8,2124,429,10,0
10/19/2020,745,0,0,8,2124,429,0,0
12-01-2020,554,0,0,4,2118,961,0,0
10-04-2020,113,0,0,8,2124,460,0,0
11-12-2020,736,0,0,11,2134,429,0,0
08/20/2020,554,0,0,11,2467,429,0,0
12-09-2020,553,0,0,3,2111,321,0,0
07-12-2020,553,0,0,6,2127,963,0,0
08/13/2020,700,0,0,8,2124,429,0,0
11/18/2020,743,0,0,4,2116,500,0,0
07-09-2020,553,0,0,4,2116,400,0,0
11-01-2020,745,0,0,8,2126,215,0,0
10/13/2020,553,0,0,11,2134,962,0,0
08-10-2020,743,0,0,4,2116,429,0,0
09/30/2020,550,0,0,7,2122,429,0,0
12-04-2020,745,0,0,4,2116,400,0,0
07/19/2020,154,0,0,11,2215,900,0,0
08/26/2020,714,0,0,3,2108,400,0,0
08/21/2020,553,0,0,12,2131,960,0,0
07/31/2020,552,0,0,7,2121,429,0,0
10-08-2020,714,0,0,9,2119,419,0,0
10/31/2020,735,0,0,9,2130,400,0,0
08-05-2020,554,0,0,3,2114,429,0,0
08/29/2020,553,0,0,11,2135,429,0,0
12/13/2020,412,0,0,3,2114,960,0,0
11/24/2020,711,0,0,9,2119,960,0,0
10-10-2020,746,0,0,11,2135,419,0,0
07/20/2020,445,0,0,6,2127,900,0,0
09/29/2020,553,0,0,3,2114,900,0,0
11/19/2020,743,0,0,12,2131,400,0,0
10-05-2020,554,0,0,12,2132,419,0,0
08-10-2020,735,0,0,4,2215,500,0,0
07/26/2020,552,0,0,6,2127,429,0,0
09/13/2020,551,0,0,4,2111,960,0,0
10/30/2020,444,0,0,6,2127,960,0,0
09-05-2020,733,0,0,6,2127,429,0,0
08/25/2020,113,0,0,8,2124,363,0,0
11-04-2020,113,0,0,6,2210,429,0,0
07-11-2020,735,0,0,3,2110,400,0,0
08-10-2020,745,0,0,4,2115,439,0,0
08/14/2020,553,0,0,8,2126,429,0,0
07-05-2020,554,0,0,8,2124,429,0,0
10/24/2020,522,0,0,7,2119,960,0,0
10/20/2020,652,0,0,9,2130,965,0,0
09/15/2020,553,0,0,9,2119,429,0,0
10-06-2020,744,0,0,3,2109,599,0,0
09/16/2020,162,0,0,4,2215,640,0,0
10/24/2020,743,0,0,12,2131,429,0,0
08/18/2020,745,0,0,12,2130,419,0,0
08-07-2020,622,0,0,9,2120,429,0,0
08/20/2020,714,0,0,9,2130,429,0,0
08/29/2020,715,0,0,6,2127,429,0,0
12-05-2020,745,0,0,1,2128,557,0,0
07-09-2020,714,0,0,9,2130,500,0,0
07/19/2020,600,0,0,12,2136,429,0,0
09-05-2020,745,0,0,3,2129,429,0,0
11/13/2020,553,0,0,9,2115,900,0,0
09-10-2020,553,0,0,4,2118,960,0,0
11-04-2020,553,0,0,4,2115,400,0,0
08/26/2020,500,0,0,12,2136,400,0,0
10-02-2020,553,0,0,12,2132,400,0,0
07-08-2020,150,0,0,7,2127,900,0,0
09/24/2020,745,0,0,4,2215,519,0,0
12-06-2020,714,0,0,9,2130,300,0,0
08-10-2020,743,0,0,4,2116,882,0,0
11-10-2020,552,0,0,9,2115,900,0,0
11/25/2020,511,0,0,6,2127,429,0,0
10-02-2020,553,0,0,8,2124,400,0,0
09/27/2020,522,0,0,6,2127,429,0,0
12/19/2020,113,0,0,4,2118,400,0,0
07/21/2020,714,0,0,3,2114,419,0,0
09/17/2020,553,0,0,3,2113,429,0,0
10-02-2020,553,0,0,6,2127,429,0,0
10/23/2020,554,0,0,7,2119,511,0,0
09/16/2020,735,0,0,8,2124,429,0,0
07-10-2020,735,0,0,6,2210,161,0,0
11/24/2020,461,0,0,9,2130,131,0,0
11-04-2020,554,0,0,7,2122,459,0,0
09/24/2020,745,0,0,4,2111,500,0,0
12-09-2020,671,0,0,7,2121,429,0,0
07-01-2020,553,0,0,3,2129,900,0,0
08/27/2020,743,0,0,4,2116,429,0,0
09-02-2020,553,0,0,9,2115,429,0,0
11/24/2020,714,0,0,7,2124,429,0,0
08-01-2020,745,0,0,3,2110,500,0,0
10/18/2020,745,0,0,3,2108,500,0,0
09/13/2020,553,0,0,6,2210,960,0,0
07/30/2020,746,0,0,3,2129,429,0,0
11-03-2020,712,0,0,9,2130,400,0,0
07/24/2020,553,0,0,12,2132,900,0,0
08-03-2020,142,0,0,8,2124,900,0,0
10/28/2020,553,0,0,3,2110,900,0,0
10-03-2020,411,0,0,11,2134,960,0,0
12/22/2020,552,0,0,6,2127,174,0,0
11-01-2020,745,0,0,7,2121,429,0,0
12/24/2020,745,0,0,6,2127,429,0,0
12/17/2020,744,0,0,11,2135,429,0,0
07/31/2020,511,0,0,7,2118,960,0,0
10-04-2020,745,0,0,4,2215,429,0,0
12/24/2020,553,0,0,1,2128,439,0,0
07/20/2020,600,0,0,7,2118,900,0,0
08-02-2020,143,0,0,4,2116,900,0,0
11/30/2020,553,0,0,7,2124,429,0,0
09-11-2020,745,0,0,9,2115,241,0,0
08/15/2020,553,0,0,9,2130,429,0,0
07-10-2020,554,0,0,4,2116,400,0,0
09-04-2020,553,0,0,8,2124,429,0,0
09/30/2020,553,0,0,11,2134,960,0,0
12/19/2020,714,0,0,8,2122,439,0,0
12-04-2020,745,0,0,4,2215,449,0,0
09/15/2020,745,0,0,4,2111,429,0,0
11-09-2020,553,0,0,8,2122,900,0,0
07/18/2020,745,0,0,9,2120,429,0,0
08/21/2020,500,0,0,4,2116,963,0,0
09/29/2020,424,0,0,1,2128,429,0,0
09-05-2020,745,0,0,3,2129,419,0,0
11-06-2020,554,0,0,11,2135,400,0,0
12/30/2020,151,0,0,4,2215,807,0,0
07/20/2020,733,0,0,1,2128,429,0,0
07-05-2020,744,0,0,7,2121,429,0,0
08-04-2020,553,0,0,9,2130,429,0,0
08/15/2020,113,0,0,9,2121,429,0,0
11-08-2020,113,0,0,9,2130,419,0,0
07-06-2020,600,0,0,7,2119,963,0,0
07/22/2020,553,0,0,9,2119,429,0,0
12-12-2020,744,0,0,3,2129,429,0,0
08-07-2020,735,0,0,11,2135,460,0,0
09/29/2020,553,0,0,3,2113,400,0,0
07/15/2020,553,0,0,3,2114,900,0,0
08/22/2020,651,0,0,7,2125,962,0,0
10/13/2020,553,0,0,3,2114,419,0,0
09-05-2020,744,0,0,9,2130,400,0,0
11/18/2020,411,0,0,3,2129,921,0,0
10/24/2020,553,0,0,8,2124,429,0,0
07-05-2020,553,0,0,8,2124,900,0,0
10-01-2020,550,0,0,7,2125,500,0,0
07/26/2020,553,0,0,7,2118,429,0,0
10/26/2020,746,0,0,11,2135,519,0,0
07-06-2020,413,0,0,11,2135,960,0,0
09-02-2020,554,0,0,9,2119,459,0,0
08-03-2020,143,0,0,12,2132,960,0,0
10/22/2020,113,0,0,9,2130,429,0,0
10-07-2020,712,0,0,6,2127,963,0,0
09-05-2020,412,0,0,11,2134,429,0,0
08/22/2020,651,0,0,9,2120,429,0,0
10/21/2020,553,0,0,7,2122,960,0,0
10/14/2020,641,0,0,9,2132,963,0,0
08/26/2020,553,0,0,7,2121,429,0,0
11/27/2020,743,0,0,3,2129,400,0,0
07/14/2020,745,0,0,8,2124,210,0,0
09/17/2020,733,0,0,7,2121,419,0,0
10-09-2020,622,0,0,6,2210,429,0,0
07-10-2020,736,0,0,9,2130,400,0,0
12-11-2020,714,0,0,6,2210,882,0,0
11-03-2020,735,0,0,9,2121,429,0,0
11/17/2020,746,0,0,12,2132,311,0,0
09/21/2020,553,0,0,11,2135,419,0,0
07/22/2020,733,0,0,4,2118,400,0,0
08/21/2020,412,0,0,4,2118,962,0,0
12-05-2020,745,0,0,1,2128,429,0,0
12/23/2020,553,0,0,4,2111,900,0,0
07/26/2020,553,0,0,7,2119,429,0,0
07/23/2020,552,0,0,8,2124,962,0,0
09/22/2020,736,0,0,3,2111,131,0,0
10/20/2020,553,0,0,6,2127,419,0,0
12/15/2020,735,0,0,6,2127,141,0,0
10/14/2020,600,0,0,9,2130,963,0,0
07/24/2020,745,0,0,11,2135,400,0,0
10/31/2020,553,0,0,4,2115,900,0,0
07-06-2020,553,0,0,9,2119,960,0,0
10/15/2020,412,0,0,7,2122,900,0,0
12/29/2020,743,0,0,6,2127,429,0,0
10-09-2020,553,0,0,3,2203,960,0,0
08-09-2020,600,0,0,12,2136,419,0,0
10/30/2020,553,0,0,12,2132,960,0,0
10-08-2020,621,0,0,4,2118,429,0,0
09-07-2020,522,0,0,11,2135,429,0,0
07-07-2020,711,0,0,7,2122,962,0,0
11-05-2020,553,0,0,3,2109,963,0,0
10/13/2020,553,0,0,3,2113,429,0,0
09/26/2020,561,0,0,11,2135,419,0,0
07/28/2020,553,0,0,7,2121,400,0,0
09-02-2020,553,0,0,9,2120,400,0,0
10/14/2020,600,0,0,7,2125,900,0,0
10-10-2020,553,0,0,9,2121,429,0,0
07/21/2020,600,0,0,7,2125,900,0,0
07/24/2020,554,0,0,7,2125,419,0,0
12/21/2020,142,0,0,12,2132,900,0,0
07/28/2020,113,0,0,7,2121,429,0,0
08/29/2020,600,0,0,4,2120,962,0,0
09-11-2020,553,0,0,4,2118,960,0,0
12-09-2020,746,0,0,11,2134,429,0,0
12/28/2020,714,0,0,4,2120,965,0,0
09/27/2020,600,0,0,4,2115,400,0,0
12/24/2020,554,0,0,7,2125,429,0,0
10-01-2020,611,0,0,12,2131,400,0,0
09-11-2020,553,0,0,7,2125,960,0,0
10/19/2020,551,0,0,4,2116,500,0,0
09/13/2020,553,0,0,8,2124,419,0,0
12/15/2020,553,0,0,4,2118,900,0,0
09/26/2020,553,0,0,3,2129,960,0,0
12/14/2020,743,0,0,8,2126,400,0,0
10-02-2020,735,0,0,3,2114,300,0,0
07/31/2020,553,0,0,6,2125,900,0,0
09-07-2020,733,0,0,11,2135,429,0,0
12-05-2020,113,0,0,11,2134,429,0,0
11-07-2020,400,0,0,4,2118,300,0,0
09/30/2020,500,0,0,8,2124,429,0,0
11-07-2020,746,0,0,9,2130,400,0,0
09/16/2020,745,0,0,4,2115,429,0,0
12-10-2020,733,0,0,7,2125,429,0,0
08/27/2020,714,0,0,12,2132,300,0,0
12/21/2020,412,0,0,7,2119,400,0,0
10/30/2020,552,0,0,9,2119,960,0,0
11-02-2020,553,0,0,7,2125,900,0,0
08/13/2020,740,0,0,8,2126,400,0,0
12-06-2020,600,0,0,1,2128,419,0,0
09/24/2020,743,0,0,8,2126,429,0,0
10/16/2020,652,0,0,9,2130,400,0,0
11-04-2020,511,0,0,12,2131,962,0,0
12/16/2020,735,0,0,4,2120,429,0,0
09/25/2020,554,0,0,8,2126,429,0,0
07/24/2020,700,0,0,12,2131,419,0,0
11/30/2020,735,0,0,8,2124,900,0,0
12/14/2020,743,0,0,4,2116,400,0,0
12/30/2020,113,0,0,11,2135,429,0,0
08-09-2020,424,0,0,11,2135,400,0,0
11-03-2020,412,0,0,9,2130,400,0,0
12-03-2020,553,0,0,8,2124,900,0,0
11-07-2020,600,0,0,3,2113,429,0,0
09/26/2020,715,0,0,11,2135,400,0,0
08/31/2020,554,0,0,9,2120,429,0,0
07-09-2020,553,0,0,4,2118,960,0,0
07/18/2020,553,0,0,8,2122,962,0,0
07/24/2020,500,0,0,7,2118,900,0,0
09/13/2020,553,0,0,8,2124,400,0,0
07/30/2020,600,0,0,8,2124,960,0,0
10/26/2020,714,0,0,4,2116,429,0,0
10/30/2020,444,0,0,4,2118,900,0,0
10/28/2020,511,0,0,3,2129,965,0,0
12-05-2020,735,0,0,3,2111,400,0,0
07-02-2020,711,0,0,8,2126,900,0,0
10-03-2020,745,0,0,6,2127,160,0,0
10/26/2020,714,0,0,9,2130,439,0,0
10/28/2020,424,0,0,3,2113,429,0,0
10-05-2020,117,0,0,4,2215,429,0,0
11/21/2020,714,0,0,4,2115,429,0,0
10/14/2020,554,0,0,11,2135,429,0,0
11-08-2020,553,0,0,3,2114,900,0,0
11-06-2020,500,0,0,6,2125,900,0,0
11/30/2020,444,0,0,12,2136,936,0,0
12-12-2020,600,0,0,4,2111,900,0,0
12-02-2020,600,0,0,3,2108,400,0,0
07/29/2020,735,0,0,4,2116,500,0,0
12-02-2020,500,0,0,11,2135,429,0,0
11/21/2020,745,0,0,8,2126,429,0,0
07/17/2020,412,0,0,3,2113,962,0,0
08/15/2020,553,0,0,3,2113,900,0,0
09/20/2020,712,0,0,4,2215,429,0,0
08/15/2020,553,0,0,4,2116,900,0,0
10/19/2020,600,0,0,4,2115,460,0,0
10/19/2020,553,0,0,9,2119,963,0,0
12-09-2020,743,0,0,11,2135,429,0,0
11/14/2020,710,0,0,6,2210,449,0,0
07/27/2020,651,0,0,9,2130,962,0,0
09-10-2020,733,0,0,8,2124,429,0,0
10/26/2020,511,0,0,8,2122,429,0,0
08/29/2020,553,0,0,4,2115,400,0,0
11-06-2020,554,0,0,11,2135,400,0,0
10-08-2020,151,0,0,9,2119,400,0,0
07/25/2020,745,0,0,8,2126,429,0,0
08/22/2020,553,0,0,6,2127,900,0,0
08-04-2020,735,0,0,8,2126,400,0,0
09/23/2020,600,0,0,6,2119,963,0,0
08-04-2020,813,0,0,9,2131,419,0,0
12-03-2020,553,0,0,1,2128,439,0,0
12/16/2020,736,0,0,4,2116,429,0,0
11/13/2020,745,0,0,7,2121,429,0,0
08/19/2020,622,0,0,3,2114,331,0,0
12-02-2020,553,0,0,7,2121,429,0,0
10-07-2020,553,0,0,4,2118,960,0,0
11-08-2020,653,0,0,6,2127,429,0,0
07-05-2020,553,0,0,4,2118,960,0,0
08/31/2020,553,0,0,9,2130,429,0,0
09/20/2020,553,0,0,3,2129,900,0,0
08/18/2020,600,0,0,8,2126,429,0,0
11/18/2020,743,0,0,9,2115,142,0,0
08/19/2020,710,0,0,9,2119,429,0,0
07/13/2020,712,0,0,4,2199,882,0,0
12/18/2020,551,0,0,7,2121,419,0,0
07-12-2020,113,0,0,12,2131,419,0,0
07/16/2020,151,0,0,7,2125,936,0,0
07/14/2020,743,0,0,7,2119,429,0,0
10-08-2020,714,0,0,7,2119,500,0,0
07/24/2020,551,0,0,9,2130,963,0,0
12/31/2020,553,0,0,11,2134,960,0,0
10-10-2020,500,0,0,12,2131,962,0,0
09/27/2020,113,0,0,3,2113,429,0,0
08-05-2020,745,0,0,9,2115,300,0,0
12-06-2020,553,0,0,7,2118,900,0,0
12/30/2020,554,0,0,11,2135,419,0,0
09/13/2020,440,0,0,9,2130,963,0,0
08-02-2020,736,0,0,12,2132,419,0,0
09-11-2020,131,0,0,3,2108,900,0,0
09/29/2020,531,0,0,6,2127,429,0,0
12/14/2020,743,0,0,9,2467,419,0,0
11-07-2020,600,0,0,4,2111,900,0,0
11-09-2020,511,0,0,7,2121,965,0,0
07/24/2020,553,0,0,9,2131,419,0,0
09-12-2020,413,0,0,8,2122,962,0,0
07/26/2020,143,100,0,12,2126,900,100,0
09/21/2020,140,0,0,1,2128,419,0,0
11-11-2020,600,0,0,6,2118,960,0,0
12-09-2020,113,0,0,1,2128,429,0,0
12-08-2020,553,0,0,9,2130,429,0,0
10/25/2020,553,0,0,12,2131,400,0,0
10-07-2020,743,0,0,4,2111,300,0,0
12-11-2020,553,0,0,3,2111,429,0,0
10/16/2020,413,0,0,12,2131,962,0,0
08/23/2020,552,0,0,9,2130,900,0,0
07-08-2020,711,0,0,9,2121,962,0,0
07-05-2020,745,0,0,6,2210,519,0,0
10/23/2020,553,0,0,7,2121,429,0,0
11/20/2020,553,0,0,7,2121,429,0,0
07/14/2020,553,0,0,4,2116,429,0,0
08/30/2020,715,0,0,7,2125,419,0,0
10-09-2020,743,0,0,9,2115,439,0,0
07-11-2020,553,0,0,8,2124,429,0,0
08-11-2020,745,0,0,3,2129,429,0,0
09/28/2020,142,0,0,8,2124,900,0,0
12/13/2020,600,0,0,9,2120,400,0,0
08-10-2020,611,0,0,6,2127,429,0,0
12-07-2020,553,0,0,4,2116,429,0,0
07/31/2020,553,0,0,11,2135,400,0,0
09/20/2020,400,0,0,12,2131,429,0,0
07-07-2020,715,0,0,7,2121,429,0,0
09-04-2020,553,0,0,3,2114,900,0,0
09/19/2020,553,0,0,6,2127,962,0,0
08/31/2020,551,0,0,11,2134,900,0,0
08-12-2020,745,0,0,3,2114,500,0,0
12-07-2020,113,0,0,9,2130,400,0,0
10/14/2020,740,0,0,11,2134,429,0,0
11-08-2020,553,0,0,4,2118,439,0,0
11/16/2020,553,0,0,9,2130,419,0,0
11-02-2020,736,0,0,1,2128,419,0,0
12/15/2020,714,0,0,4,2116,400,0,0
07-04-2020,553,0,0,12,2132,900,0,0
07-02-2020,740,0,0,4,2215,439,0,0
09/23/2020,600,0,0,9,2120,960,0,0
09-04-2020,743,0,0,4,2116,400,0,0
10/19/2020,745,0,0,4,2111,500,0,0
07-02-2020,746,0,0,8,2124,429,0,0
07/20/2020,745,0,0,4,2215,500,0,0
12/27/2020,714,0,0,12,2136,429,0,0
10-02-2020,550,0,0,8,2126,962,0,0
07/26/2020,745,0,0,11,2135,400,0,0
10/18/2020,714,0,0,4,2111,400,0,0
10/28/2020,553,0,0,7,2119,900,0,0
11/15/2020,735,0,0,4,2116,400,0,0
09/30/2020,611,0,0,11,2113,962,0,0
10/14/2020,552,0,0,7,2124,963,0,0
10/29/2020,500,0,0,11,2134,592,0,0
08/24/2020,745,0,0,1,2128,519,0,0
07/26/2020,151,0,0,7,2122,170,0,0
07/25/2020,745,0,0,3,2108,500,0,0
11/22/2020,745,0,0,7,2121,429,0,0
11/20/2020,554,0,0,4,2115,311,0,0
12/23/2020,733,0,0,9,2130,439,0,0
07/13/2020,733,0,0,9,2130,419,0,0
07-11-2020,154,0,0,6,2210,900,0,0
08-12-2020,553,0,0,7,2125,400,0,0
07/17/2020,744,0,0,3,2114,331,0,0
11/26/2020,600,0,0,9,2130,965,0,0
08-04-2020,553,0,0,9,2121,900,0,0
09/15/2020,745,0,0,3,2109,161,0,0
09/23/2020,736,0,0,12,2136,429,0,0
08/18/2020,554,0,0,11,2135,429,0,0
09/27/2020,150,0,0,4,2116,963,0,0
10/26/2020,745,0,0,4,2111,599,0,0
09/26/2020,150,0,0,7,2118,900,0,0
08-02-2020,142,0,0,6,2125,963,0,0
09/30/2020,553,0,0,4,2118,962,0,0
11/14/2020,600,0,0,7,2127,960,0,0
09-02-2020,714,0,0,7,2121,429,0,0
08/31/2020,522,0,0,4,2116,400,0,0
08/14/2020,412,0,0,9,2121,962,0,0
12-02-2020,736,0,0,7,2124,429,0,0
12-06-2020,600,0,0,4,2118,963,0,0
07/30/2020,743,0,0,9,2130,429,0,0
12-02-2020,714,0,0,4,2215,500,0,0
07/28/2020,745,0,0,9,2119,500,0,0
10-12-2020,714,0,0,12,2131,429,0,0
09-07-2020,733,0,0,4,2115,400,0,0
07-04-2020,500,0,0,7,2121,400,0,0
12/15/2020,743,0,0,7,2125,519,0,0
09/20/2020,733,0,0,4,2115,429,0,0
07-07-2020,150,35,0,8,2124,962,35,0
08/13/2020,735,0,0,11,2134,419,0,0
09/15/2020,745,0,0,7,2121,429,0,0
08/28/2020,735,0,0,4,2116,429,0,0
10/25/2020,743,0,0,7,2124,400,0,0
07/28/2020,553,0,0,4,2120,900,0,0
07/25/2020,714,0,0,3,2113,400,0,0
11-02-2020,500,0,0,6,2127,960,0,0
10-01-2020,740,0,0,8,2126,400,0,0
11-06-2020,735,0,0,11,2135,400,0,0
09-10-2020,745,0,0,3,2109,500,0,0
11/19/2020,733,0,0,12,2132,419,0,0
07/30/2020,600,0,0,4,2118,124,0,0
12-05-2020,113,0,0,8,2124,429,0,0
08/27/2020,553,0,0,9,2130,134,0,0
12/14/2020,600,0,0,4,2116,599,0,0
07/31/2020,600,0,0,8,2126,960,0,0
11/26/2020,744,0,0,1,2128,429,0,0
08-03-2020,600,0,0,4,2118,963,0,0
10-04-2020,733,0,0,6,2127,429,0,0
10/22/2020,600,0,0,6,2125,900,0,0
12/15/2020,551,0,0,11,2135,400,0,0
12-06-2020,715,0,0,7,2118,429,0,0
09/23/2020,553,0,0,7,2122,962,0,0
10-07-2020,400,0,0,9,2121,960,0,0
12/29/2020,600,0,0,9,2130,100,0,0
10/17/2020,743,0,0,3,2110,639,0,0
09-08-2020,511,0,0,8,2122,400,0,0
11-05-2020,554,0,0,8,2124,300,0,0
09-09-2020,735,0,0,3,2108,500,0,0
08-08-2020,553,0,0,8,2124,429,0,0
09-01-2020,113,0,0,7,2121,429,0,0
10/17/2020,500,0,0,8,2126,900,0,0
07-07-2020,745,0,0,3,2110,500,0,0
07-12-2020,444,0,0,12,2132,962,0,0
08/23/2020,735,0,0,8,2124,429,0,0
12/30/2020,732,0,0,6,2127,429,0,0
07-04-2020,611,0,0,12,2136,419,0,0
11/26/2020,700,0,0,7,2118,429,0,0
10/20/2020,745,0,0,11,2135,429,0,0
12/14/2020,733,0,0,3,2114,400,0,0
08/18/2020,745,0,0,11,2135,400,0,0
10-06-2020,733,0,0,11,2135,429,0,0
11-04-2020,711,0,0,4,2116,174,0,0
09-10-2020,622,0,0,3,2114,400,0,0
10/16/2020,733,0,0,4,2215,200,0,0
10/18/2020,554,0,0,1,2128,429,0,0
09-08-2020,735,0,0,9,2121,500,0,0
11/15/2020,743,0,0,6,2210,599,0,0
10-05-2020,700,0,0,9,2119,429,0,0
07/19/2020,745,0,0,7,2121,429,0,0
11/27/2020,743,0,0,3,2114,419,0,0
09/17/2020,745,0,0,11,2135,215,0,0
09-02-2020,553,0,0,4,2118,960,0,0
11/30/2020,745,0,0,12,2131,429,0,0
08-04-2020,400,0,0,8,2126,900,0,0
09/14/2020,553,0,0,4,2118,960,0,0
07-02-2020,553,0,0,9,2121,931,0,0
09-04-2020,735,0,0,8,2126,429,0,0
10-11-2020,600,0,0,8,2124,900,0,0
11-11-2020,553,0,0,8,2124,900,0,0
08/18/2020,553,0,0,7,2119,960,0,0
08/22/2020,553,0,0,7,2119,400,0,0
09/26/2020,553,0,0,7,2125,429,0,0
07/31/2020,714,0,0,7,2119,154,0,0
12/15/2020,714,0,0,6,2127,400,0,0
12/31/2020,553,0,0,12,2136,962,0,0
07/28/2020,733,0,0,12,2131,213,0,0
09/26/2020,553,0,0,4,2118,429,0,0
09-09-2020,553,0,0,9,2130,931,0,0
08/13/2020,445,0,0,7,2125,900,0,0
11/22/2020,424,0,0,7,2122,429,0,0
07/19/2020,113,300,50,8,2126,429,350,0
11/27/2020,714,0,0,4,2118,429,0,0
07/14/2020,745,0,0,6,2127,419,0,0
11-07-2020,743,0,0,4,2215,429,0,0
11-05-2020,745,0,0,11,2135,400,0,0
07-04-2020,154,0,0,9,2130,965,0,0
12-03-2020,553,0,0,8,2126,419,0,0
09-05-2020,622,0,0,4,2120,429,0,0
11/17/2020,652,0,0,4,2111,900,0,0
07/21/2020,745,0,0,9,2120,429,0,0
07/17/2020,113,0,0,7,2125,460,0,0
09-10-2020,900,0,0,4,2111,200,0,0
10/25/2020,113,0,0,9,2130,439,0,0
08/16/2020,715,0,0,8,2126,429,0,0
08/31/2020,600,0,0,3,2109,311,0,0
10/14/2020,714,0,0,9,2130,400,0,0
10/17/2020,743,0,0,11,2135,429,0,0
10/22/2020,736,0,0,8,2126,419,0,0
10-02-2020,711,0,0,12,2136,963,0,0
08/18/2020,711,0,0,12,2132,962,0,0
12/30/2020,553,0,0,9,2130,900,0,0
07-04-2020,411,0,0,9,2119,960,0,0
09-10-2020,745,0,0,11,2135,100,0,0
11/30/2020,744,0,0,12,2132,500,0,0
10-03-2020,714,0,0,9,2130,200,0,0
12/30/2020,735,0,0,8,2126,564,0,0
07-03-2020,553,0,0,7,2121,962,0,0
07-05-2020,143,0,0,1,2128,961,0,0
12-04-2020,553,0,0,9,2130,900,0,0
09/23/2020,735,0,0,4,2116,460,0,0
08-12-2020,552,0,0,11,2134,400,0,0
10-11-2020,553,0,0,8,2122,900,0,0
10/26/2020,733,0,0,4,2118,400,0,0
11-08-2020,744,0,0,8,2122,599,0,0
12-09-2020,745,0,0,1,2128,173,0,0
09/13/2020,745,0,0,6,2121,429,0,0
08-01-2020,413,0,0,9,2115,963,0,0
10/30/2020,553,0,0,4,2118,963,0,0
09-02-2020,715,0,0,6,2127,419,0,0
09-06-2020,552,0,0,7,2122,429,0,0
12/24/2020,714,0,0,7,2121,429,0,0
08/28/2020,553,0,0,4,2118,963,0,0
09-06-2020,440,0,0,11,2135,962,0,0
10/28/2020,553,0,0,6,2125,900,0,0
07/19/2020,553,0,0,12,2136,962,0,0
12/14/2020,745,0,0,1,2128,900,0,0
12-10-2020,553,0,0,7,2124,429,0,0
10/13/2020,735,0,0,4,2111,400,0,0
10/14/2020,113,0,0,11,2134,429,0,0
07/23/2020,733,0,0,4,2118,400,0,0
07/19/2020,553,0,0,1,2128,961,0,0
09/29/2020,731,0,0,4,2116,500,0,0
11/26/2020,553,0,0,3,2111,900,0,0
08/23/2020,553,0,0,9,2130,400,0,0
08/30/2020,600,0,0,8,2126,938,0,0
07/13/2020,113,0,0,12,2132,400,0,0
08/14/2020,140,0,0,1,2128,900,0,0
12-11-2020,715,0,0,9,2119,419,0,0
08/18/2020,735,0,0,4,2118,429,0,0
07/27/2020,553,0,0,4,2118,419,0,0
09-02-2020,412,0,0,7,2122,900,0,0
10/22/2020,744,0,0,12,2132,200,0,0
11/18/2020,745,0,0,11,2135,331,0,0
11/30/2020,553,0,0,3,2129,400,0,0
08-10-2020,553,0,0,3,2114,900,0,0
10-07-2020,444,0,0,12,2132,419,0,0
07/19/2020,424,0,0,4,2118,419,0,0
11-10-2020,554,0,0,4,2120,124,0,0
08/14/2020,553,0,0,7,2125,962,0,0
08-11-2020,553,0,0,11,2135,962,0,0
12-05-2020,743,0,0,8,2124,429,0,0
09-03-2020,733,0,0,7,2124,419,0,0
07/31/2020,553,0,0,11,2135,400,0,0
09/15/2020,745,0,0,11,2215,429,0,0
09-12-2020,553,0,0,11,2135,900,0,0
08-05-2020,745,0,0,8,2126,400,0,0
08/20/2020,151,0,0,4,2215,900,0,0
09/27/2020,522,0,0,4,2120,400,0,0
11-08-2020,745,0,0,1,2128,161,0,0
10-11-2020,411,0,0,11,2134,900,0,0
12-10-2020,600,0,0,7,2119,960,0,0
10-07-2020,900,0,0,8,2124,900,0,0
11/29/2020,714,0,0,4,2115,400,0,0
10-10-2020,553,0,0,9,2121,400,0,0
12/22/2020,553,0,0,4,2115,311,0,0
10/25/2020,600,0,0,11,2467,960,0,0
08-11-2020,611,0,0,7,2119,900,0,0
12/20/2020,621,0,0,11,2163,940,0,0
12/17/2020,511,0,0,9,2120,900,0,0
07/16/2020,412,0,0,12,2131,960,0,0
08/19/2020,553,0,0,3,2129,311,0,0
09/15/2020,553,0,0,1,2128,419,0,0
08-08-2020,553,0,0,6,2127,961,0,0
12/24/2020,553,0,0,6,2119,900,0,0
10/15/2020,712,0,0,9,2131,311,0,0
08-11-2020,735,0,0,9,2119,429,0,0
07/17/2020,113,0,50,11,2134,429,50,0
10/15/2020,745,0,0,6,2127,429,0,0
09/20/2020,553,0,0,3,2114,960,0,0
08/28/2020,553,0,0,9,2130,429,0,0
11-10-2020,553,0,0,4,2118,900,0,0
10/25/2020,553,0,0,6,2110,500,0,0
12/17/2020,550,0,0,9,2115,900,0,0
08/22/2020,118,0,0,4,2118,459,0,0
07/29/2020,551,0,0,8,2126,900,0,0
07/16/2020,736,0,0,1,2128,419,0,0
11-10-2020,553,0,0,6,2127,960,0,0
12/28/2020,715,0,0,9,2119,323,0,0
08-11-2020,553,0,0,3,2129,429,0,0
08-07-2020,714,0,0,11,2135,460,0,0
12/31/2020,653,0,0,6,2127,962,0,0
10-04-2020,554,0,0,12,2132,419,0,0
08-12-2020,600,0,0,4,2118,900,0,0
12-05-2020,553,0,0,8,2126,400,0,0
12-10-2020,743,0,0,8,2126,500,0,0
08-12-2020,746,0,0,7,2125,429,0,0
07/22/2020,553,0,0,7,2121,419,0,0
07/28/2020,111,200,0,8,2124,429,200,0
12-07-2020,553,0,0,1,2128,439,0,0
07/22/2020,745,0,0,11,2135,500,0,0
08-07-2020,745,0,0,4,2215,511,0,0
07/24/2020,500,0,0,11,2135,429,0,0
12/26/2020,743,0,0,3,2114,400,0,0
08/28/2020,551,0,0,12,2132,400,0,0
12-02-2020,553,0,0,6,2127,900,0,0
07-10-2020,735,0,0,3,2108,500,0,0
12/28/2020,745,0,0,3,2108,400,0,0
09-03-2020,743,0,0,4,2116,500,0,0
12-11-2020,553,0,0,3,2108,429,0,0
07/31/2020,743,0,0,9,2215,599,0,0
11/13/2020,745,0,0,9,2115,200,0,0
07-08-2020,712,0,0,4,2115,900,0,0
08/30/2020,500,0,0,3,2109,900,0,0
07/17/2020,553,0,0,3,2114,900,0,0
10/23/2020,552,0,0,12,2132,300,0,0
12-02-2020,522,0,0,6,2127,429,0,0
10/31/2020,714,0,0,4,2215,429,0,0
09-05-2020,600,0,0,4,2199,429,0,0
08-02-2020,553,0,0,8,2124,960,0,0
09-04-2020,622,0,0,4,2118,962,0,0
10/26/2020,113,0,0,1,2128,161,0,0
12/19/2020,714,0,0,3,2129,519,0,0
12-08-2020,552,0,0,6,2118,960,0,0
10/21/2020,553,0,0,6,2127,419,0,0
10-12-2020,745,0,0,6,2127,429,0,0
08-09-2020,733,0,0,3,2111,500,0,0
11-08-2020,743,0,0,4,2118,429,0,0
08-08-2020,113,0,0,3,2129,429,0,0
12-05-2020,734,0,0,4,2116,599,0,0
08/30/2020,715,0,0,8,2124,429,0,0
09/21/2020,745,0,0,3,2129,419,0,0
07/20/2020,714,0,0,9,2130,400,0,0
09/22/2020,746,0,0,3,2113,429,0,0
09-11-2020,745,0,0,3,2129,429,0,0
07/18/2020,711,0,0,12,2132,900,0,0
09/29/2020,743,0,0,11,2135,429,0,0
12/31/2020,553,0,0,11,2134,459,0,0
09/18/2020,424,0,0,3,2114,400,0,0
10-08-2020,551,0,0,8,2126,429,0,0
11-08-2020,745,0,0,4,2120,429,0,0
09/24/2020,142,0,0,8,2124,900,0,0
08/29/2020,712,0,0,9,2121,960,0,0
08/13/2020,554,0,0,8,2124,400,0,0
08-08-2020,553,0,0,7,2124,429,0,0
10-09-2020,552,0,0,9,2130,419,0,0
07-07-2020,743,0,0,4,2116,500,0,0
10/26/2020,553,0,0,9,2130,400,0,0
10/18/2020,733,0,0,4,2118,400,0,0
12/15/2020,641,0,0,3,2113,900,0,0
11-05-2020,735,0,0,3,2110,500,0,0
08-01-2020,142,0,0,12,2132,429,0,0
08-09-2020,444,0,0,8,2126,962,0,0
09/21/2020,743,0,0,12,2132,429,0,0
07/22/2020,553,0,0,3,2129,960,0,0
07/16/2020,553,0,0,9,2119,400,0,0
09-08-2020,743,0,0,6,2127,429,0,0
08/20/2020,736,0,0,11,2135,419,0,0
07/23/2020,735,0,0,4,2111,400,0,0
11/16/2020,745,0,0,8,2122,419,0,0
09/16/2020,743,0,0,3,2129,400,0,0
08/20/2020,600,0,0,8,2124,960,0,0
12/21/2020,553,0,0,6,2118,100,0,0
07-01-2020,553,0,0,7,2125,429,0,0
09/17/2020,113,0,0,7,2121,429,0,0
09-04-2020,714,0,0,4,2118,400,0,0
07-04-2020,600,0,0,4,2118,429,0,0
08/23/2020,500,0,0,11,2134,962,0,0
10/31/2020,113,0,0,9,2120,400,0,0
09/30/2020,735,0,0,3,2109,429,0,0
10/19/2020,714,0,0,11,2135,300,0,0
08-12-2020,142,0,0,9,2121,936,0,0
11-01-2020,400,0,0,6,2127,400,0,0
08/25/2020,553,0,0,1,2128,161,0,0
11/17/2020,735,0,0,4,2116,500,0,0
08/30/2020,743,0,0,9,2115,241,0,0
07-03-2020,735,0,0,3,2114,459,0,0
10/31/2020,500,0,0,7,2119,419,0,0
09/20/2020,424,0,0,4,2215,460,0,0
10-10-2020,553,0,0,11,2135,962,0,0
12-04-2020,600,0,0,11,2134,900,0,0
12/24/2020,600,0,0,12,2132,419,0,0
12/15/2020,745,0,0,3,2114,400,0,0
09/30/2020,553,0,0,9,2119,900,0,0
08-10-2020,553,0,0,4,2118,960,0,0
11/21/2020,744,0,0,4,2118,429,0,0
11-08-2020,745,0,0,11,2134,429,0,0
08-11-2020,553,0,0,3,2114,900,0,0
11/26/2020,113,0,0,7,2121,429,0,0
07-04-2020,554,0,0,9,2130,419,0,0
09-10-2020,553,0,0,1,2128,960,0,0
09-02-2020,712,0,0,9,2130,519,0,0
09/21/2020,714,0,0,4,2116,429,0,0
10-08-2020,150,0,0,11,2135,400,0,0
11/24/2020,743,0,0,12,2131,429,0,0
07-04-2020,113,0,0,7,2125,429,0,0
10/21/2020,553,0,0,4,2116,529,0,0
08-07-2020,700,0,0,3,2108,500,0,0
07/20/2020,743,0,0,6,2127,419,0,0
08/23/2020,553,0,0,7,2125,900,0,0
10/14/2020,553,0,0,9,2130,960,0,0
07/25/2020,743,0,0,9,2215,331,0,0
10/19/2020,743,0,0,3,2114,429,0,0
07-11-2020,554,0,0,9,2130,429,0,0
07-06-2020,553,0,0,12,2132,900,0,0
10/15/2020,522,0,0,11,2134,599,0,0
10/30/2020,553,0,0,4,2118,900,0,0
09-11-2020,413,0,0,1,2128,961,0,0
11-09-2020,743,0,0,3,2108,400,0,0
09-10-2020,553,0,0,9,2132,419,0,0
12-04-2020,500,0,0,8,2126,962,0,0
11/21/2020,735,0,0,6,2118,600,0,0
08-11-2020,553,0,0,6,2125,519,0,0
10-07-2020,444,0,0,12,2131,419,0,0
09-01-2020,714,0,0,11,2135,700,0,0
10-04-2020,424,0,0,7,2122,460,0,0
09/24/2020,742,0,0,11,2215,429,0,0
09/28/2020,736,0,0,11,2135,429,0,0
12-05-2020,113,0,0,8,2121,100,0,0
07-07-2020,714,0,0,3,2108,429,0,0
09/15/2020,743,0,0,3,2109,500,0,0
11/20/2020,424,0,0,12,2131,429,0,0
10/17/2020,745,0,0,4,2116,500,0,0
10/30/2020,553,0,0,4,2116,900,0,0
11-07-2020,600,0,0,12,2130,429,0,0
07-05-2020,733,0,0,9,2130,429,0,0
09-04-2020,553,0,0,3,2114,900,0,0
08/25/2020,714,0,0,9,2115,200,0,0
07/19/2020,113,0,20,7,2121,429,20,0
11/27/2020,553,0,0,9,2121,429,0,0
09/13/2020,552,0,0,3,2114,900,0,0
11/26/2020,113,0,0,7,2125,419,0,0
09/21/2020,714,0,0,4,2118,331,0,0
10/18/2020,522,0,0,3,2110,921,0,0
09/15/2020,553,0,0,6,2127,429,0,0
07/21/2020,651,0,0,8,2124,429,0,0
12/20/2020,714,0,0,3,2114,952,0,0
12/25/2020,711,0,0,3,2109,900,0,0
08/15/2020,553,0,0,3,2129,900,0,0
10-02-2020,746,0,0,11,2134,429,0,0
09/13/2020,735,0,0,4,2118,429,0,0
09/27/2020,511,0,0,11,2135,400,0,0
12-11-2020,113,0,0,8,2124,429,0,0
08/21/2020,113,0,0,12,2467,429,0,0
09/26/2020,552,0,0,11,2134,429,0,0
08/14/2020,522,0,0,3,2114,500,0,0
09/14/2020,553,0,0,8,2124,900,0,0
12-11-2020,424,0,0,8,2124,429,0,0
07/31/2020,553,0,0,9,2130,960,0,0
10/18/2020,500,0,0,4,2118,400,0,0
09/13/2020,500,0,0,11,2134,900,0,0
10-05-2020,745,0,0,6,2125,599,0,0
12-03-2020,621,0,0,6,2127,900,0,0
09/18/2020,113,0,50,11,2135,429,50,0
11/22/2020,553,0,0,4,2199,960,0,0
11-12-2020,552,0,0,6,2125,900,0,0
07/15/2020,735,0,0,8,2124,215,0,0
12/14/2020,553,0,0,9,2120,429,0,0
11/22/2020,553,0,0,1,2128,963,0,0
07/16/2020,651,0,0,9,2130,429,0,0
09/21/2020,743,0,0,7,2125,439,0,0
08/29/2020,151,0,0,4,2116,963,0,0
07/25/2020,733,0,0,11,2134,419,0,0
11-04-2020,113,0,0,12,2132,429,0,0
07-02-2020,600,0,0,7,2127,900,0,0
09/15/2020,553,0,0,3,2113,429,0,0
07/20/2020,531,0,0,4,2118,429,0,0
09/28/2020,735,0,0,8,2122,429,0,0
11-06-2020,550,0,0,11,2134,963,0,0
11-09-2020,621,0,0,1,2128,400,0,0
11-04-2020,113,0,0,12,2132,429,0,0
07/28/2020,735,0,0,3,2114,419,0,0
09/24/2020,511,0,0,7,2122,962,0,0
10/30/2020,113,0,0,7,2118,429,0,0
10/17/2020,744,0,0,3,2109,174,0,0
09/29/2020,554,0,0,11,2135,400,0,0
10/19/2020,740,0,0,8,2126,322,0,0
09/17/2020,651,0,0,4,2118,429,0,0
12-11-2020,553,0,0,6,2127,400,0,0
07/27/2020,745,0,0,3,2114,340,0,0
08-05-2020,700,0,0,9,2130,400,0,0
07/29/2020,745,0,0,3,2114,429,0,0
10/15/2020,745,0,0,4,2116,500,0,0
08/15/2020,553,0,0,3,2114,449,0,0
08/31/2020,736,0,0,8,2126,429,0,0
07/23/2020,444,0,0,8,2124,962,0,0
12/31/2020,553,0,0,7,2121,960,0,0
10-07-2020,553,0,0,3,2114,962,0,0
09/29/2020,553,0,0,4,2118,960,0,0
08-05-2020,743,0,0,6,2127,429,0,0
08-09-2020,154,50,0,11,2134,900,50,0
09/30/2020,745,0,0,12,2136,321,0,0
07-09-2020,600,0,0,11,2135,960,0,0
07-06-2020,735,0,0,9,2130,400,0,0
10-07-2020,900,0,0,8,2122,962,0,0
11/30/2020,745,0,0,7,2121,439,0,0
11-05-2020,743,0,0,9,2119,400,0,0
12/14/2020,113,0,0,4,2116,200,0,0
07-12-2020,553,0,0,3,2109,900,0,0
08-09-2020,733,0,0,3,2114,429,0,0
08/31/2020,700,0,0,9,2119,500,0,0
08/18/2020,733,0,0,12,2132,429,0,0
07/28/2020,745,0,0,9,2120,141,0,0
10/29/2020,553,0,0,6,2127,900,0,0
09-12-2020,743,0,0,4,2115,439,0,0
09-07-2020,553,0,0,9,2115,439,0,0
12-04-2020,553,0,0,4,2120,173,0,0
07-08-2020,412,0,0,12,2131,962,0,0
08/28/2020,746,0,0,3,2129,419,0,0
07/25/2020,553,0,0,4,2115,900,0,0
07-05-2020,151,0,0,7,2125,429,0,0
11/30/2020,714,0,0,4,2116,500,0,0
10/21/2020,412,0,0,9,2119,960,0,0
11-06-2020,652,0,0,12,2136,400,0,0
10/17/2020,553,0,0,4,2118,419,0,0
11-04-2020,553,0,0,1,2128,900,0,0
08-04-2020,553,0,0,7,2125,900,0,0
07-10-2020,444,0,0,8,2126,960,0,0
11/22/2020,552,0,0,4,2116,900,0,0
11-01-2020,441,0,0,11,2134,419,0,0
08/20/2020,600,0,0,12,2136,215,0,0
11/16/2020,671,0,0,11,2135,429,0,0
10/30/2020,745,0,0,12,2131,213,0,0
12/20/2020,522,0,0,6,2127,965,0,0
10-05-2020,744,0,0,9,2130,331,0,0
09/30/2020,553,0,0,9,2120,965,0,0
10/18/2020,131,0,0,12,2136,963,0,0
08/20/2020,714,0,0,1,2128,519,0,0
07-11-2020,500,0,0,11,2135,960,0,0
12-01-2020,440,0,0,11,2135,429,0,0
08-05-2020,740,0,0,8,2126,419,0,0
09/24/2020,746,0,0,11,2135,419,0,0
10-10-2020,553,0,0,9,2130,960,0,0
10/23/2020,712,0,0,4,2118,331,0,0
07-05-2020,600,0,0,7,2121,960,0,0
10/30/2020,442,0,0,4,2118,300,0,0
12-01-2020,555,0,0,4,2111,331,0,0
11/29/2020,413,0,0,11,2135,900,0,0
08-11-2020,743,0,0,7,2119,429,0,0
11/30/2020,743,0,0,1,2128,161,0,0
08/23/2020,715,0,0,8,2126,419,0,0
07/13/2020,740,0,0,6,2127,429,0,0
10-04-2020,552,0,0,4,2118,900,0,0
12-10-2020,743,0,0,7,2125,200,0,0
07-04-2020,113,0,0,8,2124,429,0,0
10-10-2020,553,0,0,8,2126,429,0,0
09-12-2020,746,0,0,4,2118,161,0,0
07/25/2020,553,0,0,8,2124,162,0,0
10/17/2020,552,0,0,1,2151,965,0,0
09/25/2020,743,0,0,7,2125,429,0,0
07/23/2020,743,0,0,7,2118,300,0,0
07-02-2020,746,0,0,11,2135,419,0,0
12/22/2020,745,0,0,11,2134,629,0,0
09/27/2020,551,0,0,3,2129,419,0,0
12/23/2020,412,0,0,4,2215,400,0,0
10-07-2020,553,0,0,1,2128,900,0,0
12-09-2020,113,0,0,8,2124,429,0,0
10/19/2020,510,0,0,4,2215,429,0,0
12/18/2020,600,0,0,4,2118,962,0,0
10/24/2020,554,0,0,8,2122,419,0,0
12-11-2020,113,0,0,7,2121,429,0,0
08-02-2020,715,0,0,9,2130,439,0,0
10/24/2020,553,0,0,4,2116,100,0,0
11/27/2020,553,0,0,9,2119,429,0,0
12/16/2020,500,0,0,4,2118,400,0,0
08-04-2020,600,0,0,9,2130,962,0,0
11-04-2020,553,0,0,8,2124,960,0,0
07-06-2020,553,0,0,9,2121,962,0,0
07-01-2020,553,0,0,7,2121,419,0,0
10/30/2020,553,0,0,3,2114,960,0,0
12-01-2020,553,0,0,6,2127,419,0,0
07/25/2020,743,0,0,4,2215,419,0,0
12-03-2020,745,0,0,8,2126,429,0,0
07-10-2020,743,0,0,6,2210,599,0,0
10/13/2020,743,0,0,7,2125,429,0,0
10/19/2020,743,0,0,7,2118,429,0,0
12-10-2020,745,0,0,6,2127,429,0,0
09-07-2020,711,0,0,4,2118,900,0,0
09-08-2020,714,0,0,1,2128,161,0,0
09-03-2020,113,0,0,1,2128,500,0,0
11/21/2020,113,0,0,7,2121,429,0,0
09/24/2020,412,0,0,7,2125,429,0,0
10/29/2020,550,0,0,7,2121,419,0,0
11/30/2020,715,0,0,1,2128,311,0,0
08-05-2020,113,0,0,9,2120,331,0,0
10/31/2020,745,0,0,3,2108,429,0,0
07/18/2020,745,0,0,3,2108,400,0,0
09/19/2020,143,0,0,8,2122,931,0,0
12/16/2020,622,0,0,4,2111,429,0,0
10-01-2020,735,0,0,4,2115,429,0,0
10-05-2020,113,0,0,9,2119,400,0,0
09-10-2020,553,0,0,9,2119,400,0,0
10-03-2020,715,0,0,3,2114,400,0,0
12/30/2020,745,0,0,3,2108,400,0,0
08/21/2020,511,0,0,3,2114,965,0,0
08/30/2020,745,0,0,3,2114,500,0,0
07-08-2020,745,0,0,8,2126,213,0,0
09-10-2020,735,0,0,9,2120,400,0,0
12/16/2020,715,0,0,12,2136,419,0,0
08-07-2020,730,0,0,3,2203,500,0,0
10-01-2020,715,0,0,3,2113,429,0,0
07-04-2020,600,0,0,4,2118,963,0,0
08-02-2020,741,0,0,4,2118,322,0,0
07/17/2020,745,0,0,12,2132,331,0,0
11/19/2020,611,0,0,12,2130,400,0,0
09-01-2020,733,0,0,4,2118,429,0,0
10/23/2020,745,0,0,12,2136,419,0,0
08-10-2020,743,0,0,4,2116,599,0,0
10/31/2020,553,0,0,9,2121,900,0,0
07/30/2020,735,0,0,12,2136,419,0,0
12-02-2020,733,0,0,3,2129,400,0,0
09/19/2020,745,0,0,9,2130,439,0,0
08-11-2020,554,0,0,11,2135,429,0,0
09/30/2020,553,0,0,6,2127,900,0,0
12-04-2020,554,0,0,8,2124,311,0,0
11-05-2020,600,0,0,4,2115,900,0,0
10/16/2020,600,0,0,4,2118,900,0,0
10/30/2020,113,150,0,11,2135,429,150,0
10/13/2020,740,0,0,7,2119,429,0,0
09/13/2020,412,0,0,9,2130,429,0,0
08-12-2020,553,0,0,3,2114,900,0,0
10/21/2020,500,0,0,12,2136,400,0,0
10-02-2020,553,0,0,6,2127,900,0,0
07/16/2020,700,0,0,8,2124,429,0,0
10/25/2020,735,0,0,4,2116,429,0,0
09/25/2020,745,0,0,4,2116,500,0,0
07/22/2020,553,0,0,12,2132,900,0,0
12/17/2020,600,0,0,6,2118,100,0,0
12/14/2020,553,0,0,4,2118,311,0,0
09/19/2020,745,0,0,4,2215,429,0,0
07-03-2020,735,0,0,6,2210,900,0,0
08/26/2020,733,0,0,1,2128,400,0,0
08-09-2020,653,0,0,7,2122,429,0,0
11-05-2020,741,0,0,9,2120,400,0,0
08-04-2020,553,0,0,4,2118,960,0,0
10/20/2020,554,0,0,3,2114,429,0,0
08/23/2020,600,0,0,8,2122,900,0,0
07-07-2020,413,0,0,12,2136,963,0,0
10-08-2020,500,0,0,12,2132,900,0,0
10/18/2020,745,0,0,9,2130,429,0,0
11-08-2020,424,0,0,12,2131,429,0,0
07-11-2020,553,0,0,4,2115,900,0,0
11-05-2020,553,0,0,7,2118,439,0,0
12/18/2020,113,0,0,3,2109,429,0,0
09-08-2020,154,0,0,6,2127,936,0,0
10/14/2020,553,0,0,4,2118,900,0,0
09/24/2020,600,0,0,4,2118,429,0,0
07-02-2020,552,0,0,8,2124,960,0,0
07/26/2020,552,0,0,8,2124,429,0,0
12-02-2020,745,0,0,3,2108,400,0,0
08/28/2020,711,0,0,3,2129,500,0,0
08-07-2020,151,0,0,9,2121,962,0,0
09/25/2020,553,0,0,6,2127,161,0,0
08-07-2020,700,0,0,1,2128,429,0,0
11-06-2020,551,0,0,4,2116,449,0,0
07/31/2020,743,0,0,6,2127,429,0,0
09/13/2020,113,0,50,11,2135,429,50,0
08/14/2020,553,0,0,6,2127,124,0,0
07/26/2020,651,0,0,9,2130,882,0,0
09/24/2020,411,0,0,4,2118,331,0,0
10/31/2020,444,0,0,12,2136,419,0,0
08/19/2020,600,0,0,12,2132,962,0,0
07/14/2020,553,0,0,7,2125,400,0,0
07-04-2020,412,0,0,9,2130,429,0,0
07/23/2020,733,0,0,11,2134,419,0,0
07-01-2020,735,0,0,12,2126,429,0,0
11-02-2020,600,0,0,6,2125,900,0,0
08/24/2020,553,0,0,3,2114,900,0,0
07/23/2020,735,0,0,4,2115,429,0,0
10/30/2020,400,0,0,4,2115,960,0,0
07/30/2020,441,0,0,8,2122,429,0,0
09-03-2020,113,0,0,4,2115,429,0,0
10/26/2020,553,0,0,9,2130,311,0,0
11-07-2020,745,0,0,3,2129,154,0,0
08-04-2020,553,0,0,7,2121,900,0,0
07/19/2020,553,0,0,4,2118,429,0,0
09/13/2020,622,0,0,4,2115,459,0,0
10-02-2020,735,0,0,3,2113,519,0,0
10/19/2020,553,0,0,11,2135,300,0,0
08/30/2020,710,0,0,4,2116,429,0,0
12-09-2020,553,0,0,8,2122,429,0,0
11-09-2020,714,0,0,4,2118,449,0,0
08-10-2020,746,0,0,8,2122,419,0,0
11/18/2020,743,0,0,6,2210,599,0,0
07/20/2020,745,0,0,3,2109,160,0,0
11/26/2020,113,0,0,3,2129,429,0,0
07-04-2020,735,0,0,4,2116,961,0,0
09-03-2020,553,0,0,3,2111,900,0,0
10-10-2020,553,0,0,9,2119,400,0,0
11-10-2020,711,0,0,6,2127,962,0,0
10-05-2020,735,0,0,11,2134,500,0,0
11-09-2020,743,0,0,4,2215,131,0,0
10-06-2020,600,0,0,8,2124,429,0,0
09-03-2020,733,0,0,1,2128,429,0,0
09/17/2020,733,0,0,12,2131,419,0,0
10/20/2020,553,0,0,7,2119,960,0,0
08-05-2020,600,0,0,7,2124,429,0,0
11/14/2020,113,0,0,7,2119,300,0,0
11/19/2020,735,0,0,4,2115,174,0,0
10/26/2020,736,0,0,1,2128,400,0,0
07/19/2020,736,0,0,12,2131,419,0,0
08-04-2020,444,0,0,9,2120,960,0,0
09/20/2020,553,0,0,3,2108,400,0,0
09/22/2020,553,0,0,3,2108,581,0,0
11/19/2020,553,0,0,9,2119,400,0,0
09/13/2020,553,0,0,6,2127,900,0,0
08/26/2020,745,0,0,9,2121,400,0,0
08/28/2020,445,0,0,9,2130,429,0,0
08-06-2020,400,0,0,7,2122,962,0,0
11/25/2020,113,0,0,12,2132,419,0,0
12/29/2020,733,0,0,12,2132,429,0,0
07-12-2020,553,0,0,7,2122,400,0,0
07/26/2020,600,0,0,9,2119,960,0,0
09/28/2020,143,0,0,7,2122,900,0,0
07/14/2020,551,0,0,8,2126,429,0,0
10/13/2020,442,0,0,3,2111,599,0,0
11/24/2020,740,0,0,4,2116,342,0,0
09/17/2020,500,0,0,8,2124,419,0,0
12-06-2020,700,0,0,8,2124,429,0,0
12/28/2020,700,0,0,7,2125,241,0,0
09-03-2020,712,0,0,11,2134,460,0,0
08/29/2020,736,0,0,6,2127,429,0,0
08/31/2020,651,0,0,6,2127,962,0,0
07/30/2020,553,0,0,4,2118,960,0,0
07/26/2020,561,0,0,11,2135,429,0,0
11-03-2020,746,0,0,1,2128,419,0,0
07-06-2020,743,0,0,8,2126,429,0,0
10-05-2020,745,0,0,3,2114,429,0,0
08/28/2020,553,0,0,9,2120,400,0,0
12/17/2020,554,0,0,12,2130,429,0,0
09-04-2020,553,0,0,3,2113,960,0,0
11/19/2020,743,0,0,3,2129,429,0,0
11-01-2020,522,0,0,11,2134,160,0,0
07-03-2020,733,0,0,3,2113,429,0,0
07/26/2020,714,0,0,4,2115,429,0,0
08-08-2020,553,0,0,6,2127,962,0,0
07-03-2020,600,0,0,4,2118,429,0,0
12/28/2020,113,1,1,6,2125,439,2,0
09/19/2020,522,0,0,4,2120,400,0,0
09/15/2020,511,0,0,3,2114,900,0,0
10-06-2020,743,0,0,4,2111,100,0,0
09-12-2020,113,0,0,9,2115,460,0,0
07/18/2020,652,0,0,3,2129,961,0,0
10/13/2020,113,0,0,4,2118,400,0,0
11/30/2020,600,0,0,7,2125,965,0,0
10/27/2020,733,0,0,9,2115,331,0,0
10-05-2020,118,0,0,4,2118,519,0,0
12/20/2020,714,0,0,3,2113,400,0,0
12/16/2020,500,0,0,4,2111,900,0,0
09-05-2020,743,0,0,3,2129,429,0,0
10/19/2020,522,0,0,3,2109,500,0,0
09/22/2020,154,0,0,3,2129,900,0,0
12/27/2020,552,0,0,11,2135,400,0,0
08-06-2020,511,0,0,8,2126,960,0,0
12-09-2020,554,0,0,12,2132,429,0,0
10/22/2020,531,0,0,4,2215,882,0,0
08-06-2020,714,0,0,9,2130,439,0,0
11-06-2020,714,0,0,4,2118,400,0,0
07/13/2020,552,0,0,4,2115,900,0,0
12/29/2020,743,0,0,11,2135,419,0,0
10/20/2020,743,0,0,6,2210,599,0,0
07-04-2020,553,0,0,3,2108,960,0,0
10-09-2020,553,0,0,12,2132,419,0,0
12/28/2020,553,0,0,6,2127,965,0,0
07/14/2020,711,0,0,8,2124,900,0,0
11/18/2020,113,0,0,7,2122,429,0,0
08/16/2020,734,0,0,11,2135,419,0,0
09/15/2020,551,0,0,4,2118,322,0,0
10/15/2020,400,0,0,7,2121,429,0,0
08-04-2020,735,0,0,9,2215,200,0,0
09-06-2020,553,0,0,7,2121,962,0,0
12/21/2020,745,0,0,12,2136,500,0,0
12-02-2020,743,0,0,7,2122,429,0,0
08/28/2020,151,0,0,7,2124,400,0,0
10/30/2020,442,0,0,11,2215,114,0,0
08/13/2020,652,0,0,9,2130,429,0,0
11/22/2020,714,0,0,12,2131,419,0,0
10/28/2020,600,0,0,6,2118,429,0,0
07/14/2020,743,0,0,8,2126,429,0,0
12/25/2020,745,0,0,8,2126,429,0,0
12/30/2020,113,0,0,4,2115,200,0,0
11-11-2020,641,0,0,4,2116,500,0,0
08-09-2020,553,0,0,8,2124,900,0,0
08/24/2020,553,0,0,9,2119,900,0,0
09-11-2020,522,0,0,8,2124,429,0,0
08/20/2020,444,0,0,12,2131,962,0,0
10/16/2020,733,0,0,6,2127,429,0,0
10-05-2020,715,0,0,1,2128,400,0,0
11/16/2020,554,0,0,8,2124,419,0,0
09-05-2020,600,0,0,12,2131,419,0,0
09/30/2020,733,0,0,4,2215,429,0,0
11-07-2020,711,0,0,4,2118,900,0,0
11-08-2020,500,0,0,11,2135,429,0,0
09/16/2020,734,0,0,3,2110,500,0,0
09/21/2020,743,0,0,4,2116,141,0,0
08-06-2020,600,0,0,4,2118,400,0,0
10/27/2020,743,0,0,6,2125,429,0,0
11-07-2020,424,0,0,4,2215,429,0,0
10/27/2020,745,0,0,3,2114,429,0,0
10-02-2020,743,0,0,4,2115,429,0,0
09/26/2020,116,1,1,4,2116,400,2,0
07/29/2020,113,0,0,9,2132,400,0,0
12/15/2020,154,0,0,3,2129,962,0,0
09-12-2020,743,0,0,12,2131,419,0,0
07/26/2020,553,0,0,3,2114,922,0,0
09/28/2020,553,0,0,12,2136,965,0,0
10/21/2020,735,0,0,12,2136,429,0,0
11/15/2020,151,0,0,6,2127,400,0,0
12/19/2020,710,0,0,4,2116,429,0,0
12/28/2020,712,0,0,4,2215,500,0,0
09-08-2020,745,0,0,3,2114,599,0,0
09-09-2020,552,0,0,1,2128,962,0,0
12/20/2020,743,0,0,4,2215,200,0,0
11/15/2020,445,0,0,11,2135,962,0,0
07-07-2020,714,0,0,4,2118,429,0,0
09/19/2020,553,0,0,4,2118,960,0,0
07-08-2020,554,0,0,11,2135,400,0,0
11/15/2020,553,0,0,6,2127,937,0,0
08-07-2020,743,0,0,3,2114,400,0,0
10/14/2020,745,0,0,4,2118,429,0,0
12/13/2020,553,0,0,7,2122,963,0,0
07-07-2020,714,0,0,8,2124,429,0,0
08/28/2020,714,0,0,4,2118,549,0,0
12-08-2020,553,0,0,4,2118,419,0,0
10-04-2020,743,0,0,12,2131,500,0,0
07/28/2020,118,200,0,7,2124,429,200,0
12-10-2020,743,0,0,3,2114,500,0,0
09/21/2020,735,0,0,8,2122,419,0,0
12/22/2020,700,0,0,12,2126,419,0,0
08/18/2020,553,0,0,4,2118,400,0,0
10/19/2020,735,0,0,4,2115,900,0,0
10-02-2020,712,0,0,9,2119,900,0,0
12-03-2020,745,0,0,4,2116,500,0,0
09/21/2020,553,0,0,8,2124,962,0,0
10/19/2020,553,0,0,9,2120,960,0,0
09/13/2020,745,0,0,9,2121,439,0,0
08-04-2020,641,0,0,12,2126,400,0,0
07/24/2020,553,0,0,3,2109,900,0,0
10/16/2020,743,0,0,1,2128,429,0,0
10/23/2020,553,0,0,6,2127,419,0,0
12-06-2020,745,0,0,7,2122,500,0,0
12/27/2020,553,0,0,3,2113,960,0,0
09/26/2020,553,0,0,4,2118,960,0,0
10/14/2020,744,0,0,6,2210,400,0,0
09/18/2020,553,0,0,4,2115,429,0,0
08-08-2020,552,0,0,11,2134,960,0,0
09/27/2020,550,0,0,12,2131,888,0,0
07/29/2020,553,0,0,8,2126,900,0,0
11/25/2020,714,0,0,4,2215,500,0,0
09-10-2020,743,0,0,7,2122,400,0,0
11/29/2020,743,0,0,4,2118,429,0,0
08-09-2020,600,0,0,4,2115,429,0,0
08/22/2020,600,0,0,9,2121,400,0,0
12-11-2020,745,0,0,8,2124,429,0,0
10/30/2020,424,0,0,4,2116,429,0,0
10/21/2020,553,0,0,3,2129,962,0,0
11/23/2020,745,0,0,3,2108,599,0,0
08-01-2020,733,0,0,6,2127,429,0,0
10-08-2020,745,0,0,3,2114,174,0,0
11/29/2020,511,0,0,12,2131,965,0,0
09/29/2020,600,0,0,4,2118,900,0,0
09/19/2020,113,0,0,4,2118,439,0,0
11/30/2020,553,0,0,3,2114,900,0,0
11/29/2020,715,0,0,12,2132,419,0,0
07/20/2020,715,0,0,11,2134,429,0,0
12-09-2020,553,0,0,6,2127,900,0,0
09-07-2020,113,0,0,9,2119,131,0,0
10/28/2020,743,0,0,4,2116,449,0,0
11/17/2020,113,0,0,4,2215,400,0,0
07/30/2020,140,0,0,9,2115,900,0,0
07/15/2020,745,0,0,6,2210,400,0,0
10/21/2020,745,0,0,3,2114,500,0,0
07-06-2020,551,0,0,12,2131,900,0,0
07-10-2020,553,0,0,4,2118,429,0,0
12/23/2020,745,0,0,12,2132,429,0,0
08-12-2020,714,0,0,4,2215,400,0,0
07/28/2020,553,0,0,7,2120,419,0,0
11/23/2020,553,0,0,1,2128,429,0,0
10-07-2020,444,0,0,12,2131,900,0,0
08/29/2020,743,0,0,12,2132,321,0,0
10-06-2020,730,0,0,7,2119,429,0,0
10-08-2020,553,0,0,9,2130,960,0,0
08-11-2020,743,0,0,9,2121,429,0,0
08/15/2020,745,0,0,7,2125,200,0,0
07-04-2020,553,0,0,9,2119,900,0,0
10/13/2020,600,0,0,9,2130,960,0,0
10/25/2020,413,0,0,6,2118,961,0,0
08-04-2020,553,0,0,12,2131,962,0,0
09/13/2020,652,0,0,9,2115,429,0,0
09-11-2020,554,0,0,11,2135,400,0,0
07/21/2020,160,0,0,1,2128,963,0,0
07-01-2020,745,0,0,4,2215,429,0,0
12/25/2020,113,0,0,9,2119,419,0,0
08-07-2020,600,0,0,3,2111,439,0,0
12-11-2020,113,0,0,4,2116,439,0,0
08-06-2020,553,0,0,4,2215,400,0,0
10/31/2020,551,0,0,9,2121,419,0,0
11-12-2020,745,0,0,9,2130,174,0,0
11-05-2020,553,0,0,12,2131,900,0,0
08/28/2020,553,0,0,4,2120,900,0,0
07-01-2020,733,0,0,11,2135,429,0,0
08/22/2020,600,0,0,6,2127,960,0,0
10/17/2020,461,0,0,6,2127,429,0,0
12-08-2020,511,0,0,8,2122,519,0,0
12-07-2020,500,0,0,8,2124,400,0,0
10-02-2020,641,0,0,3,2108,900,0,0
09/18/2020,746,0,0,3,2113,429,0,0
07-01-2020,743,0,0,7,2122,429,0,0
07-11-2020,745,0,0,9,2115,460,0,0
10/22/2020,553,0,0,9,2119,960,0,0
12/19/2020,113,0,0,11,2135,400,0,0
07/23/2020,652,0,0,9,2121,419,0,0
08-08-2020,743,0,0,6,2210,500,0,0
12/14/2020,714,0,0,4,2118,460,0,0
11/29/2020,553,0,0,4,2118,429,0,0
07/23/2020,440,0,0,4,2118,160,0,0
10-07-2020,813,0,0,11,2134,962,0,0
07-08-2020,445,0,0,8,2124,429,0,0
08/14/2020,735,0,0,4,2118,429,0,0
10-12-2020,113,0,0,11,2134,519,0,0
07-02-2020,714,0,0,6,2125,581,0,0
07-03-2020,154,0,0,4,2120,960,0,0
10/16/2020,735,0,0,6,2127,429,0,0
11-10-2020,600,0,0,8,2126,460,0,0
08/28/2020,743,0,0,9,2132,500,0,0
12/23/2020,743,0,0,4,2116,429,0,0
11/25/2020,113,0,0,4,2116,429,0,0
11-03-2020,522,0,0,8,2122,429,0,0
12-10-2020,744,0,0,1,2128,429,0,0
10/31/2020,511,0,0,3,2114,429,0,0
09-11-2020,553,0,0,9,2120,400,0,0
09/24/2020,600,0,0,9,2130,940,0,0
08/24/2020,736,0,0,7,2122,429,0,0
10/19/2020,714,0,0,4,2115,429,0,0
08-09-2020,553,0,0,1,2128,429,0,0
11/25/2020,735,0,0,8,2124,519,0,0
08/31/2020,745,0,0,4,2111,599,0,0
08/28/2020,600,0,0,7,2125,429,0,0
10/20/2020,745,0,0,4,2116,500,0,0
08/15/2020,554,0,0,12,2132,429,0,0
09/29/2020,500,0,0,12,2136,419,0,0
07-12-2020,553,0,0,9,2130,962,0,0
07/14/2020,554,0,0,3,2114,400,0,0
12/18/2020,733,0,0,9,2121,419,0,0
08/18/2020,553,0,0,11,2134,963,0,0
10-06-2020,600,0,0,4,2115,900,0,0
11-10-2020,745,0,0,4,2118,400,0,0
09-12-2020,553,0,0,3,2129,961,0,0
09-02-2020,652,0,0,9,2130,181,0,0
11/13/2020,552,0,0,3,2114,900,0,0
09/15/2020,600,0,0,3,2113,962,0,0
09/20/2020,714,0,0,3,2114,400,0,0
12/31/2020,154,0,0,12,2467,962,0,0
11-10-2020,553,0,0,3,2114,922,0,0
12/22/2020,553,0,0,6,2127,429,0,0
07/30/2020,553,0,0,7,2122,963,0,0
07/30/2020,900,0,0,11,2135,519,0,0
09-02-2020,413,0,0,9,2119,963,0,0
12/28/2020,600,0,0,9,2115,331,0,0
11/26/2020,735,0,0,3,2114,965,0,0
11/19/2020,745,0,0,11,2135,460,0,0
12/21/2020,733,0,0,6,2127,500,0,0
11-08-2020,745,0,0,3,2129,429,0,0
07-04-2020,745,0,0,9,2215,449,0,0
11/14/2020,553,0,0,6,2118,960,0,0
07/23/2020,113,0,0,7,2125,429,0,0
07/22/2020,715,0,0,8,2124,962,0,0
08/19/2020,440,0,0,1,2128,962,0,0
10-11-2020,113,0,0,9,2130,429,0,0
07-04-2020,131,0,0,9,2119,960,0,0
10/16/2020,555,0,0,11,2135,429,0,0
12/30/2020,411,0,0,8,2126,965,0,0
08-06-2020,736,0,0,7,2122,322,0,0
10/19/2020,554,0,0,12,2136,429,0,0
07/17/2020,622,0,0,4,2115,960,0,0
11-09-2020,412,0,0,3,2108,960,0,0
11-09-2020,553,0,0,1,2128,400,0,0
09/26/2020,553,0,0,11,2135,429,0,0
10/14/2020,151,0,0,9,2115,951,0,0
11/29/2020,553,0,0,6,2127,419,0,0
11/22/2020,113,0,0,4,2116,400,0,0
07-09-2020,553,0,0,1,2128,962,0,0
09/20/2020,745,0,0,12,2136,519,0,0
08/22/2020,600,0,0,8,2124,400,0,0
10-12-2020,735,0,0,3,2129,429,0,0
08-03-2020,554,0,0,12,2132,429,0,0
08/19/2020,735,0,0,4,2116,449,0,0
08/24/2020,745,0,0,6,2210,599,0,0
08-03-2020,553,0,0,7,2121,900,0,0
09/21/2020,745,0,0,11,2135,400,0,0
11-06-2020,715,0,0,4,2118,400,0,0
10-02-2020,743,0,0,3,2114,500,0,0
07-06-2020,733,0,0,9,2119,419,0,0
12/25/2020,743,0,0,12,2136,439,0,0
08-04-2020,553,0,0,8,2124,429,0,0
10/24/2020,500,0,0,4,2118,936,0,0
08/21/2020,714,0,0,3,2108,549,0,0
10/26/2020,611,0,0,8,2126,429,0,0
08-07-2020,746,0,0,7,2125,400,0,0
11-07-2020,743,0,0,7,2122,429,0,0
08/19/2020,600,0,0,4,2115,900,0,0
08/20/2020,744,0,0,4,2118,429,0,0
12-03-2020,553,0,0,9,2130,400,0,0
08/29/2020,745,0,0,11,2135,429,0,0
07-02-2020,554,0,0,4,2118,400,0,0
09/26/2020,743,0,0,4,2120,400,0,0
08/20/2020,552,0,0,7,2124,963,0,0
12-12-2020,712,0,0,3,2109,400,0,0
11-09-2020,553,0,0,7,2125,960,0,0
08-08-2020,553,0,0,8,2126,419,0,0
12/22/2020,553,0,0,9,2130,962,0,0
12-07-2020,735,0,0,8,2124,439,0,0
09-11-2020,745,0,0,4,2115,429,0,0
09-12-2020,554,0,0,12,2132,419,0,0
07-05-2020,412,0,0,8,2124,900,0,0
07/24/2020,714,0,0,7,2125,439,0,0
07/17/2020,746,0,0,1,2128,429,0,0
08-04-2020,440,0,0,11,2135,419,0,0
07/20/2020,733,0,0,6,2127,400,0,0
07/23/2020,740,0,0,8,2126,419,0,0
10/30/2020,600,0,0,12,2132,419,0,0
07-04-2020,442,0,0,4,2118,500,0,0
09-09-2020,553,0,0,4,2118,960,0,0
10/21/2020,553,0,0,6,2125,900,0,0
12/25/2020,511,0,0,8,2126,400,0,0
07/18/2020,413,0,0,8,2126,963,0,0
12/31/2020,743,0,0,3,2114,400,0,0
10/23/2020,412,0,0,3,2108,960,0,0
07-10-2020,553,0,0,8,2124,965,0,0
10/27/2020,553,0,0,12,2132,900,0,0
12-09-2020,745,0,0,7,2124,429,0,0
10/18/2020,745,0,0,11,2135,400,0,0
08-07-2020,745,0,0,3,2114,500,0,0
12/24/2020,600,0,0,7,2121,962,0,0
07/26/2020,553,0,0,7,2124,429,0,0
10-08-2020,743,0,0,9,2119,429,0,0
12/26/2020,745,0,0,1,2128,429,0,0
07-03-2020,553,0,0,3,2108,900,0,0
11/25/2020,553,0,0,4,2120,960,0,0
11/16/2020,113,0,0,7,2119,400,0,0
11-04-2020,440,0,0,7,2122,960,0,0
07-04-2020,743,0,0,12,2132,419,0,0
07/14/2020,736,0,0,8,2126,419,0,0
07/29/2020,733,0,0,4,2116,500,0,0
12/29/2020,711,0,0,3,2109,900,0,0
08/20/2020,553,0,0,4,2118,960,0,0
08/26/2020,745,0,0,12,2132,429,0,0
11/24/2020,554,0,0,12,2132,429,0,0
11/29/2020,113,0,0,4,2215,429,0,0
07/25/2020,553,0,0,12,2132,419,0,0
11/13/2020,714,0,0,8,2126,429,0,0
10-05-2020,113,0,0,6,2210,449,0,0
08-03-2020,600,0,0,4,2118,900,0,0
07-07-2020,600,0,0,9,2131,419,0,0
07/24/2020,500,0,0,4,2111,160,0,0
12-06-2020,411,0,0,12,2132,962,0,0
07-12-2020,735,0,0,9,2130,429,0,0
12-09-2020,553,0,0,8,2124,429,0,0
07/18/2020,553,0,0,12,2132,900,0,0
12/21/2020,553,0,0,3,2129,419,0,0
07-11-2020,745,0,0,3,2108,400,0,0
07-08-2020,412,0,0,9,2119,960,0,0
07-02-2020,553,0,0,6,2118,900,0,0
09-01-2020,553,0,0,12,2132,900,0,0
12/21/2020,745,0,0,3,2109,951,0,0
08/23/2020,413,0,0,11,2135,960,0,0
07-10-2020,745,0,0,7,2121,429,0,0
07/27/2020,743,0,0,1,2128,429,0,0
10/21/2020,712,0,0,6,2118,952,0,0
09/21/2020,712,0,0,7,2119,131,0,0
11-07-2020,553,0,0,7,2119,962,0,0
12/16/2020,113,0,0,9,2132,419,0,0
10/16/2020,500,0,0,3,2114,400,0,0
07/13/2020,553,0,0,6,2125,500,0,0
10-03-2020,600,0,0,8,2124,429,0,0
11/15/2020,553,0,0,9,2119,173,0,0
08/26/2020,600,0,0,11,2135,429,0,0
07-10-2020,553,0,0,6,2118,900,0,0
10/23/2020,745,0,0,12,2132,311,0,0
07-08-2020,511,0,0,4,2118,429,0,0
11-02-2020,743,0,0,7,2121,400,0,0
11/17/2020,700,0,0,9,2130,429,0,0
09/18/2020,740,0,0,9,2130,400,0,0
08-12-2020,745,0,0,4,2111,331,0,0
09-11-2020,735,0,0,9,2119,400,0,0
07/24/2020,745,0,0,4,2111,160,0,0
12/30/2020,553,0,0,3,2129,900,0,0
08-12-2020,715,0,0,6,2127,419,0,0
12/23/2020,553,0,0,9,2130,429,0,0
08-02-2020,736,0,0,7,2122,429,0,0
10-07-2020,714,0,0,4,2115,439,0,0
11/17/2020,745,0,0,12,2131,429,0,0
07-04-2020,411,0,0,7,2121,962,0,0
11-02-2020,511,0,0,3,2114,965,0,0
07-11-2020,142,0,0,1,2128,965,0,0
11/25/2020,622,0,0,8,2124,419,0,0
08/31/2020,600,0,0,12,2132,419,0,0
11-07-2020,151,0,0,3,2203,960,0,0
11-01-2020,714,0,0,6,2127,429,0,0
09/29/2020,745,0,0,9,2120,519,0,0
12/16/2020,622,0,0,1,2128,519,0,0
12/17/2020,736,0,0,3,2114,419,0,0
12-06-2020,553,0,0,7,2119,400,0,0
10-10-2020,142,0,0,9,2130,400,0,0
08/16/2020,736,0,0,4,2215,429,0,0
09-04-2020,113,0,0,8,2126,419,0,0
09-11-2020,553,0,0,7,2121,960,0,0
09-07-2020,553,0,0,1,2128,429,0,0
08/16/2020,743,0,0,9,2119,419,0,0
07/18/2020,553,0,0,3,2109,900,0,0
12/29/2020,522,0,0,12,2132,429,0,0
12/13/2020,553,0,0,3,2109,419,0,0
11-09-2020,445,0,0,7,2121,429,0,0
10/31/2020,444,0,0,11,2135,962,0,0
10-09-2020,745,0,0,9,2119,500,0,0
11-06-2020,522,0,0,7,2125,429,0,0
12/25/2020,553,0,0,1,2128,400,0,0
08/13/2020,600,0,0,12,2132,419,0,0
11/28/2020,553,0,0,6,2127,162,0,0
10-12-2020,555,0,0,6,2127,429,0,0
10/16/2020,113,0,0,11,2135,400,0,0
09/29/2020,522,0,0,6,2127,429,0,0
07-10-2020,154,0,0,7,2125,965,0,0
08/16/2020,553,0,0,3,2114,429,0,0
11/30/2020,714,0,0,7,2118,429,0,0
08/30/2020,744,0,0,11,2134,429,0,0
11-07-2020,553,0,0,9,2120,429,0,0
08/15/2020,553,0,0,4,2118,300,0,0
09-10-2020,554,0,0,11,2135,500,0,0
09-04-2020,554,0,0,8,2126,960,0,0
09-10-2020,462,0,0,1,2128,972,0,0
10/23/2020,714,0,0,4,2115,400,0,0
09/20/2020,652,0,0,4,2116,500,0,0
11/14/2020,735,0,0,3,2129,882,0,0
10/26/2020,733,0,0,9,2130,519,0,0
10/24/2020,554,0,0,4,2118,429,0,0
09/17/2020,553,0,0,4,2111,960,0,0
07/13/2020,745,0,0,3,2111,599,0,0
07-02-2020,553,0,0,3,2113,900,0,0
12/18/2020,746,0,0,11,2135,439,0,0
09/26/2020,600,0,0,8,2126,900,0,0
10/19/2020,735,0,0,6,2127,400,0,0
10/19/2020,553,0,0,3,2114,400,0,0
08-01-2020,412,0,0,1,2128,429,0,0
10-04-2020,736,0,0,4,2118,439,0,0
11-04-2020,745,0,0,8,2126,419,0,0
09-01-2020,553,0,0,6,2118,900,0,0
10/15/2020,113,0,0,7,2125,429,0,0
10/18/2020,712,0,0,6,2125,429,0,0
11/23/2020,744,0,0,7,2122,429,0,0
08/22/2020,554,0,0,11,2134,429,0,0
08/25/2020,600,0,0,4,2111,963,0,0
07-11-2020,631,0,0,9,2130,549,0,0
07/19/2020,553,0,0,11,2135,960,0,0
08-05-2020,745,0,0,9,2130,331,0,0
12/21/2020,600,0,0,11,2134,429,0,0
11-07-2020,745,0,0,3,2114,429,0,0
12-04-2020,561,0,0,4,2118,400,0,0
07/19/2020,745,0,0,7,2121,429,0,0
09/22/2020,553,0,0,7,2119,900,0,0
11/24/2020,553,0,0,9,2130,400,0,0
10-05-2020,113,0,0,3,2114,429,0,0
07/23/2020,735,0,0,4,2115,429,0,0
10/27/2020,743,0,0,12,2132,519,0,0
07-02-2020,734,0,0,6,2127,429,0,0
11/24/2020,553,0,0,9,2130,400,0,0
10/25/2020,735,0,0,4,2215,200,0,0
09/21/2020,113,0,0,1,2128,439,0,0
07/23/2020,113,0,0,12,2132,429,0,0
09-06-2020,553,0,0,4,2115,963,0,0
07-09-2020,553,0,0,4,2116,900,0,0
08/15/2020,743,0,0,4,2215,161,0,0
10-07-2020,400,0,0,9,2130,962,0,0
11/26/2020,553,0,0,11,2134,419,0,0
09-07-2020,553,0,0,6,2127,124,0,0
10/22/2020,553,0,0,3,2109,960,0,0
08/15/2020,743,0,0,9,2130,429,0,0
12/20/2020,553,0,0,9,2130,419,0,0
12/15/2020,554,0,0,11,2135,419,0,0
08/16/2020,511,0,0,4,2215,439,0,0
10-03-2020,116,0,0,4,2116,429,0,0
10-06-2020,552,0,0,4,2118,900,0,0
09/30/2020,743,0,0,3,2114,400,0,0
08-03-2020,553,0,0,8,2122,419,0,0
12/23/2020,735,0,0,1,2128,160,0,0
10/21/2020,700,0,0,3,2129,882,0,0
11/19/2020,600,0,0,4,2115,429,0,0
07/26/2020,600,0,0,4,2118,962,0,0
11-11-2020,652,0,0,4,2215,500,0,0
09-11-2020,734,0,0,4,2116,500,0,0
09/27/2020,552,0,0,8,2126,419,0,0
08/21/2020,745,0,0,7,2125,429,0,0
10/22/2020,440,0,0,12,2136,160,0,0
12-01-2020,714,0,0,11,2134,429,0,0
11-06-2020,554,0,0,11,2134,419,0,0
11/30/2020,745,0,0,7,2119,500,0,0
07/23/2020,743,0,0,6,2127,429,0,0
10/16/2020,553,0,0,7,2119,900,0,0
11/14/2020,553,0,0,6,2127,429,0,0
11-04-2020,600,0,0,7,2119,700,0,0
12/16/2020,743,0,0,9,2119,400,0,0
11/20/2020,745,0,0,7,2121,429,0,0
09/26/2020,553,0,0,7,2121,429,0,0
11/13/2020,735,0,0,3,2114,174,0,0
09-01-2020,746,0,0,12,2131,419,0,0
07/30/2020,743,0,0,9,2130,460,0,0
08/29/2020,733,0,0,11,2135,429,0,0
08-06-2020,412,0,0,4,2115,429,0,0
07/21/2020,621,0,0,4,2120,960,0,0
08/31/2020,733,0,0,6,2127,419,0,0
10-02-2020,743,0,0,4,2116,429,0,0
11-08-2020,142,0,0,11,2135,900,0,0
09-04-2020,745,0,0,1,2128,700,0,0
11/30/2020,113,0,0,6,2127,400,0,0
08-01-2020,700,0,0,4,2118,500,0,0
08-09-2020,553,0,0,6,2127,429,0,0
11-06-2020,600,0,0,4,2111,960,0,0
09-06-2020,522,0,0,3,2108,161,0,0
08/14/2020,554,0,0,8,2126,419,0,0
11/19/2020,735,0,0,4,2115,599,0,0
09-10-2020,700,0,0,4,2118,429,0,0
11/30/2020,444,0,0,11,2134,962,0,0
12/21/2020,553,0,0,6,2125,900,0,0
10-07-2020,553,0,0,12,2132,419,0,0
09/13/2020,500,0,0,11,2135,429,0,0
10/14/2020,714,0,0,9,2130,429,0,0
09/30/2020,444,0,0,12,2131,962,0,0
08/29/2020,553,0,0,3,2129,962,0,0
08/14/2020,500,0,0,4,2111,900,0,0
08/23/2020,554,0,0,12,2136,419,0,0
09/21/2020,441,0,0,4,2116,581,0,0
09/13/2020,113,0,0,6,2125,400,0,0
08-12-2020,554,0,0,11,2467,429,0,0
08/28/2020,712,0,0,4,2215,400,0,0
07-05-2020,553,0,0,9,2124,429,0,0
07-09-2020,552,0,0,7,2122,419,0,0
11/25/2020,411,0,0,9,2130,429,0,0
12/17/2020,554,0,0,12,2132,429,0,0
09/19/2020,552,0,0,9,2120,429,0,0
11/21/2020,553,0,0,8,2124,429,0,0
12-09-2020,113,0,0,8,2124,429,0,0
08/30/2020,113,0,0,8,2126,400,0,0
09/21/2020,622,0,0,4,2215,963,0,0
07-05-2020,745,0,0,1,2128,400,0,0
10/17/2020,735,0,0,8,2126,215,0,0
08-04-2020,715,0,0,4,2115,429,0,0
07-08-2020,745,0,0,3,2114,429,0,0
09/23/2020,600,0,0,6,2118,963,0,0
09/20/2020,553,0,0,9,2119,429,0,0
12/29/2020,553,0,0,3,2116,963,0,0
07-10-2020,553,0,0,7,2119,900,0,0
09-04-2020,113,0,0,3,2108,419,0,0
12-07-2020,745,0,0,12,2136,459,0,0
08/29/2020,745,0,0,11,2135,429,0,0
08/16/2020,553,0,0,6,2127,174,0,0
11-08-2020,733,0,0,6,2127,429,0,0
12-02-2020,600,0,0,7,2122,429,0,0
10-07-2020,553,0,0,9,2130,900,0,0
07-02-2020,553,0,0,3,2114,900,0,0
07-06-2020,652,0,0,3,2114,900,0,0
12/19/2020,745,0,0,9,2215,331,0,0
11-10-2020,554,0,0,3,2111,429,0,0
10/14/2020,500,0,0,6,2210,900,0,0
12/27/2020,554,0,0,3,2129,429,0,0
11/25/2020,700,0,0,7,2119,900,0,0
11/26/2020,746,0,0,7,2125,429,0,0
07-02-2020,553,0,0,4,2118,900,0,0
07/16/2020,735,0,0,12,2131,161,0,0
11-04-2020,743,0,0,8,2122,400,0,0
08-12-2020,421,0,0,3,2109,631,0,0
12/18/2020,553,0,0,6,2127,429,0,0
08/15/2020,510,0,0,9,2120,962,0,0
08-12-2020,600,0,0,4,2118,429,0,0
10-03-2020,641,0,0,9,2119,963,0,0
10-04-2020,745,0,0,12,2132,519,0,0
11/27/2020,421,0,0,9,2120,900,0,0
08/31/2020,732,0,0,4,2118,429,0,0
10-02-2020,714,0,0,3,2114,429,0,0
11-02-2020,600,0,0,6,2125,962,0,0
08/17/2020,553,0,0,6,2119,100,0,0
09-12-2020,555,0,0,3,2129,460,0,0
09/30/2020,553,0,0,9,2119,900,0,0
07-05-2020,553,0,0,8,2124,400,0,0
08/22/2020,550,0,0,3,2129,961,0,0
07-07-2020,151,0,0,9,2130,963,0,0
10/15/2020,736,0,0,8,2124,449,0,0
08/23/2020,746,0,0,6,2127,460,0,0
07/16/2020,745,0,0,3,2109,500,0,0
07/28/2020,151,0,0,8,2126,900,0,0
08-01-2020,600,0,0,9,2121,963,0,0
08/21/2020,552,0,0,4,2115,174,0,0
08-04-2020,813,0,0,9,2132,419,0,0
09-08-2020,731,0,0,9,2120,429,0,0
10-02-2020,735,0,0,9,2130,400,0,0
07-10-2020,511,0,0,6,2125,965,0,0
08-04-2020,553,0,0,8,2122,592,0,0
11/26/2020,424,0,0,1,2128,429,0,0
07/16/2020,113,0,0,6,2127,429,0,0
08/26/2020,151,0,0,6,2127,900,0,0
10/31/2020,733,0,0,9,2120,400,0,0
09-08-2020,553,0,0,12,2131,429,0,0
07-09-2020,600,0,0,8,2122,900,0,0
09/13/2020,712,0,0,4,2118,439,0,0
10-08-2020,730,0,0,3,2111,900,0,0
10-09-2020,151,0,0,4,2115,900,0,0
10-11-2020,622,0,0,9,2130,900,0,0
08-06-2020,444,0,0,9,2130,962,0,0
07/13/2020,600,0,0,8,2126,960,0,0
12-06-2020,553,0,0,7,2125,459,0,0
10/25/2020,553,0,0,12,2131,419,0,0
11-09-2020,736,0,0,1,2128,419,0,0
12/23/2020,552,0,0,1,2128,960,0,0
09-02-2020,651,0,0,1,2128,429,0,0
08/27/2020,743,0,0,4,2116,599,0,0
11-03-2020,511,0,0,7,2125,962,0,0
08/18/2020,553,0,0,8,2124,400,0,0
12-03-2020,553,0,0,8,2124,429,0,0
09-09-2020,600,0,0,11,2134,965,0,0
07/15/2020,733,0,0,9,2130,322,0,0
08/24/2020,553,0,0,6,2127,460,0,0
12/19/2020,735,0,0,6,2127,429,0,0
10/20/2020,553,0,0,7,2121,131,0,0
09/19/2020,554,0,0,7,2122,429,0,0
07-09-2020,714,0,0,8,2124,400,0,0
07/30/2020,715,0,0,11,2134,429,0,0
08-01-2020,600,0,0,4,2118,960,0,0
10/28/2020,113,0,0,11,2135,429,0,0
12/25/2020,714,0,0,6,2127,519,0,0
11/28/2020,745,0,0,8,2126,429,0,0
08/23/2020,412,0,0,9,2119,429,0,0
10/31/2020,714,0,0,9,2130,429,0,0
11-03-2020,600,0,0,11,2134,962,0,0
08/13/2020,553,0,0,7,2121,429,0,0
12-09-2020,553,0,0,3,2113,150,0,0
07-02-2020,444,0,0,3,2129,500,0,0
12/30/2020,424,0,0,9,2130,429,0,0
07-05-2020,600,0,0,7,2125,400,0,0
08-11-2020,552,0,0,7,2121,150,0,0
07-08-2020,113,0,0,3,2109,429,0,0
10/27/2020,553,0,0,8,2124,419,0,0
11/24/2020,714,0,0,8,2124,400,0,0
09/23/2020,553,0,0,3,2129,429,0,0
12-11-2020,500,0,0,12,2136,960,0,0
10/23/2020,711,0,0,12,2132,900,0,0
07-05-2020,713,0,0,12,2131,962,0,0
09-07-2020,600,0,0,11,2134,960,0,0
11-11-2020,745,0,0,9,2119,419,0,0
08/20/2020,553,0,0,9,2119,100,0,0
12-11-2020,714,0,0,4,2215,460,0,0
07/28/2020,733,0,0,7,2122,429,0,0
11-07-2020,745,0,0,11,2134,429,0,0
08/15/2020,743,0,0,7,2125,429,0,0
10/27/2020,715,0,0,11,2135,429,0,0
10/24/2020,736,0,0,4,2118,429,0,0
07-03-2020,113,0,0,6,2127,429,0,0
07-08-2020,441,0,0,11,2134,429,0,0
12/22/2020,553,0,0,9,2130,429,0,0
07/18/2020,745,0,0,3,2114,429,0,0
09/29/2020,900,0,0,8,2124,429,0,0
10/19/2020,113,0,300,4,2118,429,300,0
12-11-2020,553,0,0,6,2127,400,0,0
11/18/2020,745,0,0,11,2135,419,0,0
08/20/2020,735,0,0,9,2120,400,0,0
07/14/2020,733,0,0,7,2125,429,0,0
08-04-2020,600,0,0,9,2130,960,0,0
12/30/2020,745,0,0,9,2121,500,0,0
09/29/2020,744,0,0,3,2113,429,0,0
10/19/2020,600,0,0,4,2111,900,0,0
07-10-2020,553,0,0,4,2118,962,0,0
11/20/2020,113,0,250,4,2116,429,250,0
11/26/2020,745,0,0,1,2128,429,0,0
10/25/2020,735,0,0,9,2119,429,0,0
09-11-2020,522,0,0,7,2121,429,0,0
07/25/2020,553,0,0,9,2130,400,0,0
09-06-2020,553,0,0,6,2127,900,0,0
11/24/2020,730,0,0,6,2127,429,0,0
11/23/2020,600,0,0,8,2124,429,0,0
09-10-2020,154,0,0,7,2124,900,0,0
08-04-2020,813,0,0,12,2131,960,0,0
09-07-2020,553,0,0,8,2124,500,0,0
11-01-2020,600,0,0,4,2116,429,0,0
08-03-2020,511,0,0,9,2215,900,0,0
10/16/2020,735,0,0,4,2215,100,0,0
08/22/2020,714,0,0,8,2126,429,0,0
07-12-2020,743,0,0,9,2120,400,0,0
10-11-2020,553,0,0,3,2129,960,0,0
08/29/2020,600,0,0,6,2125,965,0,0
11/27/2020,714,0,0,9,2115,429,0,0
07-01-2020,743,0,0,6,2127,419,0,0
11/14/2020,522,0,0,9,2119,400,0,0
09-06-2020,600,0,0,6,2127,161,0,0
07-03-2020,745,0,0,3,2116,449,0,0
12/19/2020,714,0,0,6,2127,429,0,0
09/23/2020,424,0,0,4,2115,400,0,0
07/13/2020,553,0,0,7,2119,400,0,0
08-06-2020,745,0,0,4,2116,400,0,0
09-03-2020,733,0,0,8,2124,419,0,0
07-01-2020,743,0,0,6,2127,213,0,0
10/30/2020,113,0,0,3,2113,429,0,0
12/26/2020,735,0,0,11,2134,429,0,0
11-02-2020,113,0,0,11,2135,429,0,0
08-01-2020,143,0,0,11,2134,124,0,0
08/20/2020,553,0,0,6,2127,900,0,0
11/29/2020,740,0,0,6,2118,888,0,0
09/21/2020,745,0,0,7,2121,429,0,0
11/17/2020,700,0,0,9,2130,429,0,0
08/23/2020,500,0,0,6,2210,960,0,0
10-07-2020,553,0,0,12,2132,419,0,0
07-09-2020,412,0,0,3,2109,161,0,0
07/31/2020,553,0,0,3,2108,900,0,0
10/17/2020,553,0,0,4,2215,439,0,0
10/21/2020,600,0,0,11,2135,439,0,0
11/30/2020,743,0,0,3,2129,400,0,0
07-09-2020,600,0,0,9,2130,429,0,0
10-03-2020,143,0,0,9,2119,900,0,0
07-09-2020,131,0,0,8,2126,960,0,0
08/29/2020,422,0,0,9,2115,900,0,0
07/14/2020,743,0,0,1,2128,213,0,0
07-08-2020,553,0,0,7,2119,962,0,0
09-04-2020,554,0,0,9,2120,311,0,0
11/23/2020,552,0,0,4,2115,960,0,0
10/27/2020,113,0,0,12,2136,419,0,0
09/17/2020,554,0,0,8,2124,429,0,0
11/25/2020,714,0,0,4,2215,449,0,0
10-11-2020,113,5,5,4,2118,429,10,0
09/19/2020,151,0,0,9,2130,429,0,0
07/29/2020,700,0,0,4,2118,331,0,0
07/24/2020,553,0,0,11,2135,400,0,0
11/22/2020,733,0,0,11,2134,439,0,0
12/22/2020,735,0,0,11,2215,460,0,0
12/20/2020,424,0,0,3,2108,439,0,0
09/13/2020,553,0,0,9,2120,400,0,0
10/19/2020,511,0,0,12,2132,439,0,0
11/13/2020,600,0,0,3,2129,400,0,0
10/27/2020,745,0,0,4,2118,429,0,0
09/24/2020,735,0,0,3,2129,429,0,0
11-02-2020,743,0,0,4,2115,161,0,0
08/20/2020,400,0,0,7,2118,960,0,0
12/18/2020,900,0,0,6,2124,400,0,0
08-11-2020,113,0,0,12,2131,429,0,0
09/23/2020,711,0,0,1,2128,962,0,0
09-06-2020,743,0,0,6,2127,161,0,0
12/25/2020,733,0,0,9,2215,449,0,0
09/18/2020,600,0,0,4,2199,429,0,0
07-06-2020,600,0,0,9,2119,500,0,0
12/16/2020,113,0,0,6,2127,400,0,0
12/25/2020,735,0,0,4,2115,400,0,0
09/19/2020,160,0,0,6,2125,900,0,0
07-10-2020,553,0,0,3,2129,400,0,0
09-10-2020,715,0,0,8,2124,400,0,0
10/28/2020,600,0,0,3,2114,960,0,0
10-11-2020,553,0,0,11,2135,400,0,0
08/31/2020,600,0,0,6,2118,900,0,0
10/29/2020,746,0,0,6,2127,429,0,0
11-02-2020,113,0,0,11,2135,429,0,0
10/23/2020,522,0,0,7,2127,960,0,0
12-01-2020,745,0,0,6,2210,599,0,0
10/18/2020,745,0,0,7,2121,429,0,0
07/16/2020,553,0,0,7,2119,400,0,0
11/26/2020,746,0,0,7,2121,429,0,0
07/13/2020,552,0,0,8,2126,962,0,0
12/16/2020,700,0,0,8,2124,400,0,0
12/20/2020,651,0,0,9,2121,429,0,0
11/20/2020,554,0,0,6,2127,419,0,0
10-10-2020,531,0,0,7,2125,459,0,0
08/22/2020,553,0,0,9,2121,429,0,0
10-03-2020,116,0,0,4,2111,340,0,0
07/23/2020,553,0,0,12,2467,429,0,0
09/23/2020,741,0,0,9,2115,965,0,0
11-09-2020,733,0,0,1,2128,519,0,0
08/31/2020,745,0,0,3,2109,429,0,0
11-04-2020,412,0,0,6,2127,429,0,0
09/24/2020,611,0,0,7,2125,311,0,0
07/18/2020,600,0,0,12,2131,900,0,0
08-11-2020,622,0,0,12,2136,429,0,0
08/26/2020,600,0,0,7,2122,900,0,0
07/18/2020,711,0,0,12,2132,500,0,0
11/26/2020,743,0,0,12,2131,429,0,0
11-06-2020,424,0,0,7,2124,429,0,0
12/18/2020,745,0,0,9,2120,460,0,0
11/21/2020,554,0,0,8,2124,400,0,0
12/19/2020,735,0,0,11,2134,429,0,0
07/25/2020,600,0,0,6,2118,960,0,0
11-10-2020,744,0,0,1,2128,429,0,0
08/26/2020,746,0,0,8,2126,419,0,0
09/30/2020,553,0,0,8,2124,960,0,0
10/22/2020,735,0,0,3,2110,152,0,0
09-11-2020,113,0,0,6,2127,429,0,0
08/21/2020,745,0,0,6,2210,500,0,0
07/19/2020,700,0,0,7,2125,400,0,0
10-10-2020,553,0,0,9,2121,400,0,0
11/23/2020,553,0,0,12,2132,311,0,0
09/26/2020,745,0,0,4,2111,500,0,0
11-09-2020,511,0,0,8,2124,960,0,0
08/13/2020,735,0,0,11,2215,460,0,0
09/28/2020,700,0,0,9,2120,429,0,0
08/21/2020,746,0,0,12,2136,429,0,0
08-06-2020,113,0,0,4,2120,429,0,0
12-07-2020,522,0,0,11,2135,429,0,0
09-12-2020,113,0,0,4,2115,439,0,0
10-08-2020,600,0,0,7,2122,962,0,0
10-10-2020,553,0,0,3,2108,960,0,0
10/20/2020,600,0,0,4,2116,960,0,0
09/22/2020,600,0,0,12,2136,900,0,0
12/29/2020,744,0,0,3,2110,599,0,0
09-08-2020,553,0,0,7,2125,960,0,0
11-09-2020,714,0,0,11,2135,400,0,0
07/13/2020,735,0,0,9,2130,429,0,0
11-03-2020,735,0,0,9,2130,400,0,0
10-06-2020,113,0,0,8,2126,400,0,0
10/30/2020,553,0,0,3,2114,960,0,0
09-01-2020,522,0,0,4,2118,429,0,0
12-10-2020,113,0,0,11,2135,400,0,0
12/18/2020,743,0,0,7,2122,429,0,0
11-01-2020,743,0,0,7,2125,429,0,0
09-06-2020,551,0,0,9,2119,400,0,0
08/28/2020,745,0,0,11,2134,429,0,0
07-05-2020,553,0,0,4,2116,150,0,0
11-02-2020,745,0,0,11,2135,429,0,0
08/27/2020,553,0,0,7,2119,429,0,0
10/25/2020,715,0,0,9,2130,400,0,0
07/30/2020,400,0,0,1,2128,960,0,0
07/24/2020,553,0,0,12,2136,900,0,0
07/31/2020,744,0,0,7,2125,429,0,0
08-02-2020,113,0,0,4,2118,429,0,0
10/26/2020,522,0,0,3,2110,599,0,0
11/17/2020,600,0,0,4,2111,900,0,0
09/30/2020,553,0,0,9,2131,960,0,0
11-06-2020,113,0,0,3,2129,460,0,0
08-05-2020,511,0,0,11,2135,965,0,0
07/16/2020,600,0,0,7,2125,900,0,0
08/30/2020,553,0,0,4,2111,100,0,0
09/14/2020,600,0,0,4,2118,962,0,0
11-01-2020,621,0,0,8,2124,960,0,0
08-03-2020,711,0,0,11,2135,900,0,0
11/15/2020,553,0,0,6,2118,963,0,0
12-09-2020,600,0,0,8,2124,400,0,0
08/13/2020,735,0,0,11,2215,429,0,0
12-03-2020,550,0,0,8,2126,419,0,0
11-02-2020,553,0,0,6,2118,963,0,0
09-08-2020,553,0,0,4,2118,960,0,0
08-04-2020,444,0,0,8,2124,962,0,0
10/21/2020,424,0,0,7,2125,429,0,0
08-01-2020,743,0,0,6,2127,429,0,0
08/14/2020,600,0,0,11,2135,960,0,0
08/21/2020,745,0,0,3,2109,449,0,0
09/15/2020,735,0,0,8,2126,429,0,0
12-02-2020,745,0,0,4,2116,599,0,0
09/16/2020,740,0,0,1,2128,500,0,0
12/26/2020,735,0,0,4,2118,300,0,0
10/30/2020,714,0,0,3,2108,500,0,0
08/20/2020,554,0,0,4,2116,429,0,0
07/28/2020,553,0,0,9,2130,960,0,0
08/31/2020,714,0,0,4,2116,400,0,0
12/27/2020,553,0,0,11,2134,940,0,0
12-11-2020,736,0,0,8,2124,429,0,0
09-02-2020,442,0,0,9,2115,300,0,0
07/28/2020,553,0,0,9,2119,900,0,0
11-12-2020,714,0,0,9,2119,429,0,0
12/19/2020,510,0,0,4,2115,962,0,0
09-09-2020,551,0,0,9,2130,900,0,0
11-02-2020,113,0,0,8,2126,460,0,0
11-07-2020,711,0,0,4,2118,900,0,0
07/13/2020,743,0,0,11,2134,429,0,0
07-10-2020,743,0,0,11,2134,429,0,0
09/30/2020,552,0,0,1,2128,519,0,0
10/21/2020,745,0,0,4,2111,174,0,0
09/30/2020,553,0,0,7,2119,900,0,0
07/23/2020,714,0,0,4,2115,400,0,0
07/14/2020,600,0,0,4,2116,400,0,0
12/15/2020,743,0,0,3,2114,500,0,0
09/30/2020,500,0,0,3,2129,960,0,0
08-08-2020,553,0,0,9,2121,429,0,0
10/18/2020,733,0,0,6,2127,400,0,0
09-10-2020,743,0,0,12,2131,429,0,0
11/14/2020,745,0,0,9,2115,429,0,0
07-05-2020,743,0,0,12,2136,419,0,0
07/23/2020,553,0,0,4,2118,962,0,0
09/19/2020,651,0,0,1,2128,340,0,0
10-06-2020,743,0,0,4,2215,460,0,0
12-07-2020,554,0,0,9,2130,300,0,0
12-10-2020,715,0,0,6,2127,429,0,0
10-03-2020,550,0,0,6,2210,449,0,0
08-11-2020,600,0,0,12,2136,960,0,0
10/23/2020,714,0,0,7,2121,429,0,0
11/25/2020,715,0,0,4,2118,429,0,0
07/22/2020,733,0,0,3,2203,965,0,0
08/25/2020,600,0,0,4,2118,960,0,0
11/15/2020,650,0,0,6,2125,449,0,0
09/21/2020,113,0,0,9,2119,400,0,0
09/30/2020,813,0,0,1,2128,963,0,0
07-12-2020,553,0,0,4,2215,400,0,0
10-02-2020,554,0,0,9,2130,429,0,0
07/21/2020,600,0,0,6,2125,900,0,0
11-07-2020,553,0,0,6,2127,960,0,0
08-04-2020,553,0,0,1,2128,419,0,0
09/20/2020,641,0,0,4,2115,900,0,0
12/23/2020,424,0,0,11,2135,419,0,0
10/22/2020,553,0,0,8,2124,900,0,0
10/15/2020,554,0,0,4,2215,400,0,0
12-09-2020,551,0,0,12,2132,900,0,0
09/26/2020,743,0,0,7,2125,429,0,0
12-06-2020,735,0,0,3,2108,400,0,0
12/28/2020,511,0,0,7,2119,429,0,0
07-12-2020,734,0,0,4,2116,500,0,0
12/14/2020,700,0,0,4,2118,400,0,0
10-06-2020,554,0,0,7,2125,419,0,0
08/22/2020,552,0,0,8,2122,962,0,0
10/27/2020,736,0,0,9,2120,429,0,0
07-04-2020,744,0,0,4,2118,429,0,0
09/19/2020,745,0,0,7,2121,429,0,0
09-05-2020,600,0,0,4,2115,429,0,0
10/18/2020,500,0,0,7,2125,419,0,0
08-12-2020,736,0,0,4,2116,429,0,0
07-12-2020,714,0,0,4,2118,400,0,0
10/14/2020,740,0,0,11,2134,429,0,0
08/25/2020,600,0,0,4,2118,429,0,0
07/29/2020,553,0,0,9,2130,962,0,0
10-03-2020,621,0,0,7,2119,962,0,0
12/28/2020,650,0,0,6,2127,960,0,0
09-12-2020,553,0,0,1,2128,400,0,0
09/16/2020,542,0,0,12,2132,900,0,0
11-09-2020,553,0,0,6,2118,322,0,0
11/29/2020,553,0,0,4,2215,500,0,0
10/22/2020,735,0,0,4,2115,400,0,0
09/17/2020,621,0,0,11,2135,900,0,0
11/26/2020,740,0,0,4,2215,439,0,0
09/13/2020,113,5,5,4,2120,429,10,0
10/31/2020,113,0,0,3,2108,429,0,0
08/31/2020,550,0,0,1,2128,419,0,0
08/31/2020,151,0,0,9,2115,900,0,0
10-05-2020,714,0,0,3,2114,331,0,0
09-07-2020,715,0,0,3,2108,500,0,0
12-10-2020,554,0,0,7,2122,419,0,0
09-08-2020,745,0,0,11,2134,429,0,0
10-09-2020,622,0,0,9,2119,900,0,0
12/16/2020,554,0,0,11,2135,429,0,0
09/20/2020,151,0,0,7,2122,962,0,0
12/27/2020,745,0,0,1,2128,429,0,0
11-07-2020,653,0,0,9,2119,429,0,0
07/13/2020,553,0,0,8,2124,900,0,0
09/15/2020,424,0,0,7,2125,419,0,0
09/21/2020,743,0,0,4,2118,593,0,0
11/16/2020,745,0,0,7,2121,160,0,0
08/30/2020,553,0,0,6,2127,900,0,0
07/13/2020,600,0,0,12,2131,419,0,0
09/22/2020,622,0,0,4,2118,429,0,0
09-09-2020,522,0,0,8,2126,429,0,0
10/20/2020,600,0,0,3,2114,900,0,0
12/18/2020,731,0,0,7,2119,700,0,0
07-11-2020,511,0,0,9,2121,429,0,0
12-02-2020,743,0,0,7,2125,429,0,0
09/26/2020,151,0,0,9,2215,300,0,0
10/20/2020,736,0,0,3,2113,429,0,0
08-01-2020,600,0,0,9,2119,900,0,0
07-04-2020,600,0,0,8,2122,938,0,0
08/13/2020,442,0,0,3,2108,429,0,0
09/17/2020,743,0,0,1,2128,429,0,0
07-09-2020,743,0,0,9,2119,429,0,0
11/20/2020,113,0,0,9,2215,460,0,0
12-01-2020,553,0,0,7,2119,519,0,0
10/26/2020,113,0,0,7,2125,419,0,0
07/16/2020,553,0,0,12,2132,960,0,0
11/26/2020,735,0,0,3,2109,549,0,0
08-03-2020,553,0,0,6,2118,900,0,0
08-09-2020,735,0,0,9,2130,400,0,0
11-05-2020,551,0,0,11,2135,960,0,0
07/19/2020,734,0,0,3,2113,429,0,0
08-10-2020,745,0,0,1,2128,429,0,0
08/26/2020,736,0,0,9,2121,400,0,0
07/22/2020,744,0,0,9,2119,429,0,0
10/20/2020,424,0,0,3,2113,429,0,0
12/26/2020,743,0,0,4,2118,429,0,0
10/21/2020,745,0,0,12,2132,459,0,0
08/18/2020,553,0,0,8,2124,900,0,0
12-08-2020,113,200,0,7,2125,429,200,0
11-02-2020,743,0,0,4,2215,460,0,0
10/31/2020,554,0,0,7,2125,429,0,0
08-04-2020,813,0,0,9,2130,900,0,0
10/17/2020,715,0,0,8,2122,419,0,0
11/26/2020,113,0,0,4,2116,400,0,0
08/16/2020,151,0,0,6,2127,951,0,0
11-09-2020,743,0,0,1,2128,419,0,0
07-01-2020,745,0,0,8,2124,429,0,0
10/25/2020,711,0,0,8,2124,963,0,0
08-10-2020,553,0,0,9,2119,400,0,0
08/28/2020,745,0,0,3,2114,331,0,0
11-04-2020,113,0,0,7,2119,429,0,0
11/18/2020,745,0,0,9,2130,419,0,0
09-08-2020,611,0,0,4,2118,960,0,0
12/28/2020,745,0,0,11,2134,400,0,0
07-10-2020,553,0,0,3,2129,900,0,0
12/26/2020,553,0,0,11,2135,429,0,0
08/21/2020,142,0,0,4,2215,900,0,0
12-08-2020,113,0,0,11,2135,429,0,0
09-10-2020,553,0,0,6,2127,429,0,0
12-03-2020,511,0,0,12,2136,519,0,0
09/23/2020,142,0,0,12,2136,900,0,0
10-11-2020,553,0,0,7,2124,900,0,0
09/28/2020,554,0,0,12,2132,419,0,0
09/16/2020,746,0,0,11,2135,429,0,0
12/13/2020,551,0,0,12,2132,400,0,0
11/17/2020,553,0,0,7,2122,419,0,0
08/16/2020,554,0,0,7,2125,960,0,0
07/18/2020,113,0,0,7,2121,429,0,0
08/27/2020,413,0,0,11,2134,960,0,0
07/17/2020,622,0,0,4,2215,963,0,0
12-11-2020,743,0,0,6,2210,599,0,0
08-05-2020,714,0,0,8,2124,599,0,0
11-03-2020,553,0,0,8,2126,419,0,0
07-12-2020,553,0,0,9,2119,900,0,0
11-09-2020,554,0,0,7,2122,429,0,0
10-08-2020,733,0,0,1,2128,429,0,0
09/15/2020,714,0,0,6,2127,557,0,0
12-06-2020,554,0,0,1,2128,400,0,0
10/14/2020,600,0,0,4,2116,963,0,0
07-05-2020,553,0,0,11,2135,900,0,0
08-09-2020,113,0,0,4,2116,429,0,0
11/25/2020,553,0,0,6,2127,960,0,0
11/13/2020,745,0,0,3,2114,331,0,0
10-11-2020,553,0,0,7,2118,900,0,0
12/25/2020,712,0,0,3,2109,593,0,0
07/30/2020,553,0,0,4,2116,900,0,0
10/23/2020,553,0,0,6,2127,311,0,0
12/28/2020,600,0,0,7,2122,962,0,0
07/13/2020,552,0,0,4,2118,900,0,0
09/23/2020,511,0,0,12,2131,429,0,0
08-03-2020,113,0,0,11,2135,400,0,0
09-12-2020,553,0,0,6,2118,150,0,0
12/22/2020,553,0,0,6,2127,429,0,0
11-07-2020,600,0,0,4,2118,900,0,0
07/14/2020,712,0,0,9,2121,429,0,0
08/25/2020,745,0,0,1,2128,161,0,0
11/29/2020,554,0,0,9,2120,311,0,0
08-08-2020,413,0,0,7,2119,960,0,0
08/13/2020,711,0,0,1,2128,962,0,0
10/27/2020,712,0,0,6,2125,429,0,0
07/17/2020,743,0,0,4,2116,200,0,0
08-03-2020,714,0,0,11,2134,519,0,0
12-03-2020,424,0,0,8,2124,419,0,0
09-11-2020,553,0,0,7,2119,400,0,0
10/29/2020,554,0,0,8,2124,419,0,0
09-11-2020,714,0,0,8,2124,429,0,0
12-04-2020,600,0,0,3,2129,900,0,0
10-07-2020,113,0,0,1,2128,429,0,0
09-12-2020,113,0,0,4,2120,460,0,0
11-11-2020,444,0,0,8,2126,962,0,0
11/29/2020,745,0,0,3,2109,500,0,0
09/23/2020,736,0,0,9,2130,400,0,0
09/24/2020,745,0,0,6,2127,429,0,0
08/22/2020,733,0,0,3,2111,439,0,0
09-08-2020,733,0,0,7,2125,429,0,0
11/29/2020,600,0,0,4,2115,400,0,0
12/15/2020,553,0,0,8,2124,429,0,0
08/30/2020,700,0,0,12,2132,400,0,0
10-12-2020,745,0,0,11,2135,331,0,0
10/15/2020,714,0,0,3,2129,429,0,0
09/20/2020,743,0,0,11,2135,429,0,0
07/23/2020,441,0,0,6,2127,400,0,0
09/29/2020,652,0,0,11,2135,419,0,0
07/26/2020,715,0,0,4,2115,429,0,0
12/15/2020,554,0,0,4,2118,400,0,0
11/16/2020,553,0,0,9,2120,429,0,0
11/20/2020,621,0,0,7,2122,962,0,0
09-04-2020,511,0,0,9,2126,900,0,0
11/26/2020,744,0,0,1,2128,429,0,0
12-11-2020,553,0,0,1,2128,340,0,0
11-12-2020,745,0,0,9,2130,213,0,0
10/18/2020,900,0,0,6,2210,174,0,0
09/15/2020,552,0,0,6,2118,961,0,0
08-09-2020,553,0,0,4,2118,960,0,0
09/30/2020,413,0,0,1,2128,429,0,0
07/29/2020,745,0,0,4,2116,419,0,0
11-04-2020,554,0,0,12,2126,419,0,0
12-03-2020,551,0,0,8,2126,960,0,0
07/13/2020,745,0,0,11,2134,519,0,0
08/23/2020,554,0,0,9,2121,429,0,0
09/29/2020,553,0,0,6,2127,960,0,0
10/29/2020,553,0,0,12,2131,900,0,0
10/17/2020,553,0,0,8,2124,400,0,0
08/25/2020,554,0,0,12,2136,419,0,0
08/23/2020,522,0,0,12,2136,429,0,0
11/16/2020,745,0,0,7,2121,429,0,0
11-04-2020,700,0,0,8,2124,429,0,0
10/27/2020,551,0,0,8,2126,429,0,0
07-09-2020,553,0,0,4,2116,124,0,0
12-12-2020,424,0,0,8,2124,429,0,0
11/20/2020,553,0,0,8,2124,429,0,0
09-08-2020,712,0,0,3,2108,500,0,0
08-10-2020,511,0,0,12,2131,429,0,0
08/19/2020,440,0,0,9,2130,400,0,0
11/21/2020,553,0,0,7,2119,962,0,0
08/16/2020,154,0,0,11,2134,965,0,0
12/18/2020,731,0,0,3,2114,981,0,0
08/19/2020,522,0,0,4,2118,900,0,0
12-05-2020,552,0,0,1,2128,960,0,0
08/27/2020,400,0,0,9,2130,419,0,0
07/21/2020,553,0,0,7,2119,960,0,0
07-01-2020,711,0,0,3,2129,100,0,0
09/15/2020,600,0,0,12,2132,400,0,0
12/18/2020,511,0,0,8,2124,429,0,0
11/24/2020,113,0,0,7,2124,429,0,0
10-03-2020,553,0,0,9,2119,429,0,0
09/27/2020,743,0,0,3,2129,419,0,0
11-09-2020,735,0,0,7,2121,429,0,0
09-06-2020,600,0,0,8,2124,960,0,0
10-06-2020,744,0,0,3,2110,593,0,0
08-04-2020,714,0,0,7,2118,439,0,0
11-04-2020,551,0,0,4,2115,900,0,0
09-05-2020,733,0,0,9,2120,400,0,0
07-03-2020,736,0,0,7,2125,419,0,0
08-06-2020,714,0,0,4,2215,400,0,0
08/15/2020,745,0,0,11,2135,460,0,0
10-05-2020,714,0,0,11,2135,429,0,0
10/13/2020,744,0,0,3,2129,419,0,0
09/13/2020,714,0,0,8,2126,400,0,0
08/13/2020,715,0,0,4,2116,429,0,0
12/24/2020,553,0,0,4,2116,963,0,0
07/13/2020,741,0,0,6,2210,449,0,0
09/16/2020,733,0,0,8,2126,400,0,0
12/15/2020,553,0,0,11,2134,963,0,0
12/21/2020,745,0,0,1,2128,400,0,0
12-02-2020,552,0,0,3,2129,960,0,0
12/30/2020,150,0,0,6,2118,100,0,0
07/23/2020,743,0,0,1,2128,429,0,0
10-02-2020,735,0,0,4,2116,215,0,0
10-09-2020,600,0,0,9,2120,900,0,0
10/30/2020,553,0,0,8,2122,888,0,0
12/17/2020,735,0,0,3,2129,500,0,0
12-10-2020,651,0,0,7,2122,419,0,0
11/13/2020,550,0,0,8,2124,300,0,0
09-07-2020,715,0,0,8,2122,419,0,0
07-04-2020,600,0,0,8,2124,429,0,0
07/19/2020,553,0,0,12,2130,419,0,0
09/13/2020,743,0,0,4,2111,400,0,0
12/29/2020,553,0,0,7,2119,429,0,0
09/15/2020,554,0,0,8,2126,419,0,0
07/23/2020,553,0,0,4,2215,900,0,0
11/23/2020,553,0,0,3,2108,400,0,0
07-05-2020,553,0,0,4,2118,962,0,0
08/15/2020,714,0,0,6,2127,400,0,0
08/15/2020,700,0,0,8,2122,419,0,0
07-09-2020,553,0,0,6,2118,963,0,0
12/28/2020,714,0,0,7,2125,419,0,0
09/21/2020,740,0,0,3,2108,419,0,0
10/13/2020,522,0,0,9,2130,331,0,0
12-11-2020,745,0,0,6,2127,429,0,0
08/19/2020,113,0,0,12,2136,400,0,0
09-01-2020,553,0,0,4,2116,500,0,0
09/27/2020,611,0,0,3,2129,960,0,0
11-07-2020,714,0,0,3,2114,419,0,0
08-10-2020,736,0,0,11,2135,419,0,0
11/21/2020,745,0,0,12,2131,429,0,0
12-01-2020,700,0,0,3,2129,500,0,0
07-02-2020,553,0,0,6,2210,940,0,0
09-01-2020,600,0,0,4,2116,962,0,0
08-12-2020,745,0,0,4,2111,161,0,0
12/13/2020,552,0,0,12,2136,888,0,0
11/15/2020,736,0,0,6,2125,449,0,0
12/28/2020,553,0,0,9,2130,900,0,0
12-09-2020,641,0,0,6,2118,961,0,0
10/16/2020,745,0,0,12,2132,213,0,0
12/15/2020,554,0,0,11,2135,400,0,0
10-04-2020,552,0,0,9,2130,419,0,0
09/20/2020,714,0,0,12,2131,300,0,0
08-06-2020,600,0,0,6,2125,963,0,0
07/18/2020,622,0,0,3,2129,961,0,0
09/21/2020,412,0,0,1,2128,962,0,0
11/18/2020,741,0,0,4,2111,952,0,0
07-01-2020,735,0,0,7,2122,429,0,0
09/25/2020,553,0,0,3,2129,900,0,0
11/20/2020,553,0,0,7,2121,429,0,0
11/30/2020,745,0,0,4,2111,170,0,0
08/30/2020,552,0,0,7,2119,439,0,0
07-09-2020,553,0,0,4,2118,960,0,0
12/17/2020,745,0,0,7,2122,429,0,0
08/28/2020,733,0,0,1,2128,429,0,0
09/22/2020,113,0,0,9,2119,429,0,0
11/30/2020,442,0,0,4,2111,340,0,0
11/15/2020,554,0,0,7,2121,429,0,0
12/16/2020,745,0,0,11,2135,429,0,0
07-03-2020,113,0,0,9,2115,429,0,0
11-11-2020,511,0,0,8,2124,900,0,0
08-10-2020,743,0,0,11,2134,549,0,0
08-07-2020,500,0,0,3,2109,900,0,0
12/15/2020,731,0,0,4,2118,429,0,0
07/20/2020,745,0,0,9,2115,300,0,0
09/27/2020,551,0,0,9,2121,963,0,0
11/19/2020,553,0,0,9,2119,400,0,0
12/24/2020,141,0,0,8,2124,960,0,0
10-06-2020,740,0,0,4,2118,331,0,0
10/29/2020,442,0,0,6,2210,429,0,0
07/31/2020,445,0,0,3,2114,960,0,0
09/13/2020,745,0,0,3,2110,500,0,0
09/21/2020,424,0,0,4,2215,439,0,0
11-03-2020,553,0,0,12,2131,962,0,0
09-04-2020,522,0,0,9,2467,419,0,0
11-02-2020,745,0,0,7,2119,100,0,0
08-02-2020,552,0,0,7,2122,539,0,0
08/20/2020,424,0,0,4,2116,429,0,0
09-01-2020,743,0,0,9,2120,429,0,0
07/22/2020,553,0,0,9,2119,900,0,0
08-07-2020,745,0,0,11,2135,400,0,0
11/29/2020,413,0,0,12,2131,419,0,0
09-08-2020,553,0,0,12,2132,900,0,0
09-06-2020,745,0,0,12,2132,160,0,0
07/14/2020,743,0,0,6,2127,419,0,0
10/28/2020,553,0,0,4,2111,960,0,0
08-06-2020,744,0,0,7,2121,429,0,0
11/23/2020,511,0,0,8,2124,400,0,0
07-06-2020,735,0,0,3,2114,331,0,0
08/28/2020,552,0,0,3,2109,963,0,0
07/27/2020,740,0,0,4,2111,500,0,0
11/25/2020,554,0,0,4,2111,439,0,0
08/26/2020,745,0,0,3,2109,161,0,0
10/13/2020,712,0,0,9,2130,215,0,0
07-07-2020,553,0,0,3,2129,900,0,0
09/18/2020,553,0,0,4,2111,960,0,0
10-04-2020,554,0,0,7,2122,460,0,0
08/14/2020,700,0,0,4,2115,400,0,0
11/28/2020,733,0,0,9,2115,241,0,0
09-08-2020,542,0,0,4,2118,429,0,0
08/30/2020,600,0,0,7,2119,900,0,0
07-12-2020,553,0,0,6,2118,900,0,0
10-04-2020,413,0,0,6,2127,900,0,0
10/16/2020,714,0,0,4,2118,429,0,0
11/14/2020,211,0,0,3,2108,500,0,0
09-04-2020,736,0,0,7,2125,429,0,0
12/16/2020,714,0,0,6,2127,460,0,0
12-07-2020,500,0,0,7,2121,963,0,0
12-10-2020,735,0,0,3,2111,400,0,0
08/28/2020,553,0,0,7,2119,400,0,0
07-12-2020,553,0,0,6,2118,900,0,0
08-03-2020,424,0,0,3,2114,429,0,0
07-06-2020,600,0,0,6,2119,963,0,0
11-10-2020,554,0,0,8,2124,429,0,0
08/31/2020,712,0,0,4,2199,599,0,0
09/18/2020,553,0,0,8,2124,419,0,0
09/20/2020,150,0,0,9,2121,960,0,0
08/28/2020,522,0,0,7,2122,429,0,0
12-10-2020,652,0,0,4,2118,161,0,0
08/25/2020,740,0,0,8,2126,429,0,0
09/17/2020,113,0,0,12,2131,429,0,0
11-08-2020,712,0,0,4,2118,331,0,0
10/16/2020,553,0,0,3,2109,960,0,0
09/30/2020,743,0,0,7,2125,429,0,0
09/30/2020,743,0,0,6,2125,429,0,0
10/26/2020,735,0,0,7,2121,519,0,0
08/23/2020,715,0,0,7,2125,429,0,0
07/16/2020,743,0,0,12,2131,429,0,0
09/29/2020,711,0,0,7,2125,599,0,0
08-04-2020,813,0,0,9,2121,400,0,0
12-02-2020,622,0,0,8,2124,419,0,0
09/22/2020,522,0,0,3,2114,460,0,0
07/16/2020,554,0,0,12,2132,429,0,0
08-04-2020,444,0,0,8,2126,962,0,0
08/22/2020,714,0,0,4,2215,100,0,0
09-03-2020,600,0,0,11,2135,900,0,0
12-12-2020,711,0,0,3,2116,960,0,0
10-07-2020,440,0,0,7,2119,429,0,0
09/28/2020,113,0,0,4,2215,439,0,0
08-12-2020,714,0,0,4,2215,460,0,0
08-04-2020,553,0,0,4,2118,960,0,0
09/15/2020,600,0,0,12,2132,419,0,0
10-04-2020,743,0,0,12,2136,419,0,0
09-05-2020,113,0,0,9,2130,429,0,0
10/29/2020,113,0,0,4,2116,160,0,0
12-06-2020,554,0,0,12,2136,419,0,0
08/26/2020,745,0,0,12,2131,340,0,0
07-11-2020,553,0,0,12,2130,952,0,0
10-04-2020,554,0,0,7,2125,429,0,0
10/20/2020,553,0,0,4,2118,960,0,0
11/13/2020,600,0,0,3,2111,963,0,0
07/13/2020,553,0,0,6,2127,429,0,0
09-08-2020,600,0,0,12,2130,900,0,0
07/20/2020,553,0,0,6,2125,960,0,0
07/18/2020,553,0,0,12,2132,900,0,0
12/27/2020,113,0,0,12,2136,429,0,0
11/22/2020,553,0,0,4,2118,429,0,0
08/13/2020,735,0,0,11,2215,460,0,0
11/26/2020,113,0,0,3,2111,429,0,0
10/31/2020,500,0,0,12,2136,419,0,0
10-09-2020,553,0,0,8,2124,419,0,0
11/21/2020,553,0,0,8,2124,400,0,0
11/25/2020,113,0,0,7,2125,419,0,0
12/22/2020,600,0,0,4,2115,400,0,0
10/29/2020,553,0,0,4,2215,960,0,0
12-08-2020,553,0,0,8,2126,429,0,0
10/19/2020,553,0,0,8,2126,419,0,0
11/17/2020,553,0,0,1,2128,429,0,0
11-05-2020,553,0,0,4,2115,900,0,0
12-04-2020,745,0,0,9,2130,429,0,0
12-02-2020,700,0,0,4,2215,519,0,0
07/22/2020,730,0,0,12,2132,962,0,0
12/14/2020,743,0,0,3,2108,400,0,0
08-01-2020,745,0,0,4,2115,400,0,0
07/28/2020,553,0,0,9,2119,160,0,0
08-05-2020,715,0,0,4,2115,429,0,0
10/29/2020,700,0,0,3,2129,241,0,0
09-10-2020,735,0,0,11,2135,429,0,0
11-05-2020,600,0,0,11,2134,963,0,0
10/25/2020,553,0,0,3,2109,900,0,0
10-01-2020,743,0,0,4,2111,449,0,0
12/16/2020,745,0,0,4,2215,981,0,0
12/24/2020,714,0,0,7,2124,439,0,0
12/20/2020,600,0,0,1,2128,400,0,0
07/15/2020,113,0,0,6,2125,429,0,0
09-02-2020,113,0,150,11,2134,429,150,0
10/30/2020,700,0,0,4,2116,500,0,0
11/28/2020,552,0,0,4,2120,400,0,0
10-01-2020,745,0,0,6,2127,100,0,0
08-04-2020,600,0,0,12,2131,419,0,0
07/27/2020,553,0,0,4,2215,900,0,0
10/19/2020,154,0,0,3,2110,960,0,0
11/30/2020,740,0,0,4,2116,213,0,0
07-01-2020,745,0,0,3,2110,429,0,0
10-02-2020,621,0,0,6,2119,900,0,0
07/20/2020,735,0,0,12,2132,429,0,0
09/17/2020,410,0,0,3,2129,961,0,0
10/30/2020,740,0,0,11,2135,331,0,0
07/22/2020,735,0,0,6,2127,429,0,0
12/19/2020,553,0,0,9,2130,962,0,0
10/31/2020,424,0,0,11,2135,429,0,0
09-06-2020,734,0,0,7,2121,429,0,0
10-08-2020,113,0,0,4,2116,429,0,0
10-08-2020,715,0,0,7,2119,429,0,0
07-03-2020,744,0,0,8,2126,419,0,0
07/17/2020,553,0,0,9,2130,419,0,0
10/18/2020,745,0,0,1,2128,429,0,0
08/20/2020,711,0,0,4,2118,960,0,0
12/18/2020,553,0,0,12,2131,419,0,0
07-06-2020,714,0,0,3,2109,400,0,0
07-09-2020,445,0,0,6,2210,173,0,0
08/20/2020,745,0,0,7,2121,429,0,0
11-11-2020,745,0,0,3,2114,429,0,0
07-07-2020,735,0,0,11,2135,400,0,0
10-08-2020,554,0,0,8,2124,459,0,0
11-10-2020,735,0,0,4,2115,400,0,0
10-08-2020,714,0,0,6,2127,150,0,0
12-06-2020,553,0,0,3,2113,960,0,0
07/16/2020,743,0,0,11,2135,419,0,0
07-08-2020,600,0,0,7,2119,900,0,0
08-10-2020,731,0,0,7,2119,800,0,0
11/16/2020,554,0,0,9,2130,311,0,0
09/25/2020,553,0,0,6,2127,900,0,0
10/28/2020,412,0,0,4,2116,429,0,0
11/13/2020,553,0,0,6,2125,449,0,0
10/31/2020,554,0,0,12,2132,419,0,0
09-04-2020,745,0,0,11,2135,429,0,0
11/26/2020,553,0,0,12,2136,400,0,0
09-06-2020,600,0,0,1,2128,962,0,0
08/30/2020,743,0,0,4,2115,460,0,0
10-01-2020,522,0,0,9,2119,419,0,0
09-05-2020,715,0,0,8,2124,400,0,0
07/25/2020,551,0,0,7,2122,963,0,0
07-12-2020,442,0,0,11,2135,429,0,0
10/25/2020,712,0,0,9,2130,331,0,0
12-01-2020,734,0,0,6,2210,449,0,0
09/23/2020,553,0,0,12,2136,419,0,0
12/23/2020,735,0,0,4,2215,500,0,0
12/31/2020,653,0,0,4,2118,962,0,0
07-11-2020,745,0,0,1,2128,500,0,0
09-05-2020,714,0,0,8,2122,311,0,0
12/29/2020,714,0,0,7,2125,500,0,0
12-04-2020,745,0,0,4,2116,400,0,0
10-08-2020,746,0,0,11,2134,241,0,0
10/30/2020,600,0,0,4,2111,900,0,0
08-04-2020,745,0,0,6,2127,900,0,0
11/30/2020,553,0,0,12,2136,952,0,0
10-08-2020,553,0,0,12,2132,960,0,0
12/31/2020,700,0,0,4,2118,429,0,0
10/22/2020,740,0,0,4,2115,460,0,0
10/21/2020,733,0,0,1,2128,419,0,0
09/19/2020,142,0,0,9,2119,900,0,0
11-10-2020,743,0,0,11,2135,429,0,0
08/17/2020,745,0,0,6,2127,400,0,0
08/15/2020,553,0,0,12,2132,900,0,0
12/19/2020,714,0,0,4,2215,429,0,0
08/22/2020,113,0,0,9,2119,400,0,0
08-04-2020,813,0,0,9,2120,900,0,0
12/13/2020,743,0,0,8,2126,429,0,0
08/24/2020,733,0,0,4,2118,460,0,0
07-04-2020,653,0,0,8,2126,429,0,0
08/26/2020,743,0,0,6,2127,460,0,0
11-10-2020,712,0,0,9,2130,331,0,0
07/31/2020,553,0,0,7,2121,960,0,0
12/26/2020,500,0,0,11,2135,429,0,0
10/22/2020,714,0,0,4,2115,429,0,0
08/29/2020,711,0,0,4,2118,963,0,0
08/29/2020,553,0,0,4,2115,900,0,0
10-09-2020,600,0,0,3,2109,962,0,0
09/22/2020,745,0,0,3,2114,141,0,0
07-11-2020,553,0,0,6,2119,900,0,0
08-03-2020,743,0,0,9,2115,331,0,0
12/16/2020,731,0,0,3,2129,460,0,0
08/28/2020,745,0,0,9,2119,429,0,0
09/13/2020,554,0,0,11,2135,429,0,0
10/30/2020,600,0,0,7,2125,900,0,0
10-11-2020,553,0,0,1,2128,900,0,0
10/27/2020,652,0,0,6,2127,962,0,0
08/19/2020,745,0,0,12,2136,429,0,0
07-03-2020,553,0,0,9,2130,419,0,0
09-01-2020,553,0,0,7,2119,960,0,0
10/24/2020,113,0,0,4,2118,429,0,0
08/18/2020,554,0,0,1,2128,519,0,0
12/20/2020,553,0,0,12,2136,429,0,0
08/25/2020,714,0,0,4,2215,460,0,0
12/20/2020,622,0,0,1,2128,900,0,0
10/30/2020,400,0,0,4,2118,900,0,0
08-03-2020,744,0,0,4,2199,449,0,0
08/13/2020,553,0,0,4,2118,429,0,0
10/30/2020,444,0,0,12,2136,419,0,0
08-12-2020,553,0,0,6,2127,900,0,0
10-08-2020,113,0,0,12,2132,429,0,0
08/28/2020,745,0,0,9,2121,429,0,0
11/19/2020,554,0,0,9,2130,419,0,0
09/27/2020,735,0,0,9,2130,400,0,0
10-02-2020,553,0,0,1,2128,900,0,0
07-11-2020,151,0,0,9,2121,931,0,0
07-06-2020,745,0,0,6,2210,161,0,0
07-11-2020,554,0,0,11,2135,429,0,0
08/13/2020,411,0,0,8,2124,965,0,0
10/21/2020,554,0,0,3,2114,429,0,0
08-05-2020,746,0,0,12,2131,419,0,0
11/30/2020,714,0,0,9,2120,429,0,0
11-01-2020,733,0,0,7,2119,400,0,0
11/22/2020,411,0,0,4,2116,429,0,0
09/30/2020,745,0,0,8,2126,400,0,0
09/24/2020,553,0,0,9,2132,419,0,0
08/24/2020,113,0,0,4,2115,400,0,0
09-12-2020,743,0,0,3,2114,500,0,0
09/24/2020,522,0,0,9,2115,429,0,0
10/26/2020,733,0,0,4,2115,429,0,0
11/27/2020,600,0,0,3,2114,174,0,0
08/15/2020,700,0,0,9,2115,215,0,0
11/20/2020,500,0,0,8,2126,429,0,0
10/22/2020,700,0,0,3,2111,400,0,0
09/16/2020,700,0,0,1,2128,962,0,0
09/13/2020,714,0,0,9,2130,322,0,0
09/17/2020,140,0,0,4,2116,900,0,0
07/23/2020,743,0,0,9,2130,419,0,0
11-11-2020,745,0,0,4,2116,400,0,0
07-11-2020,746,0,0,11,2135,400,0,0
08/30/2020,511,0,0,4,2116,429,0,0
12/25/2020,113,0,0,9,2119,429,0,0
12/26/2020,113,0,0,11,2135,400,0,0
11/20/2020,113,0,0,1,2128,429,0,0
12-09-2020,745,0,0,3,2111,429,0,0
11-10-2020,714,0,0,6,2125,429,0,0
07/15/2020,553,0,0,12,2136,960,0,0
08-06-2020,731,0,0,12,2136,839,0,0
09/29/2020,712,0,0,4,2115,200,0,0
08/31/2020,553,0,0,4,2111,150,0,0
10/15/2020,531,0,0,4,2118,429,0,0
10/30/2020,736,0,0,1,2128,400,0,0
08/16/2020,600,0,0,12,2131,900,0,0
08/21/2020,113,0,0,11,2134,322,0,0
11-11-2020,553,0,0,8,2126,962,0,0
08-07-2020,733,0,0,6,2127,459,0,0
11-05-2020,151,0,0,7,2122,962,0,0
07-06-2020,735,0,0,11,2467,181,0,0
12/24/2020,553,0,0,12,2132,900,0,0
09/17/2020,731,0,0,3,2114,882,0,0
11/20/2020,745,0,0,4,2111,429,0,0
12-12-2020,553,0,0,1,2128,900,0,0
09/22/2020,552,0,0,7,2122,900,0,0
09/23/2020,142,0,0,4,2120,900,0,0
09-02-2020,746,0,0,6,2127,419,0,0
09-01-2020,440,0,0,4,2118,331,0,0
10/22/2020,553,0,0,9,2121,429,0,0
07/17/2020,561,0,0,1,2128,900,0,0
11/22/2020,745,0,0,3,2109,500,0,0
12-02-2020,553,0,0,6,2210,900,0,0
12/16/2020,745,0,0,3,2110,599,0,0
07/13/2020,600,0,0,7,2125,419,0,0
10-05-2020,710,0,0,8,2126,400,0,0
08/13/2020,714,0,0,3,2108,429,0,0
10/22/2020,744,0,0,3,2109,429,0,0
07/29/2020,553,0,0,3,2110,900,0,0
12/17/2020,440,0,0,8,2126,960,0,0
10-07-2020,553,0,0,11,2135,400,0,0
11/23/2020,746,0,0,11,2134,429,0,0
07/18/2020,733,0,0,4,2116,400,0,0
12/14/2020,743,0,0,4,2215,460,0,0
09-05-2020,552,0,0,9,2130,965,0,0
11-10-2020,746,0,0,1,2128,429,0,0
08/31/2020,553,0,0,3,2129,419,0,0
11-10-2020,745,0,0,8,2124,400,0,0
12/25/2020,715,0,0,9,2130,400,0,0
09/20/2020,740,0,0,7,2124,400,0,0
08/19/2020,714,0,0,4,2115,429,0,0
11/28/2020,553,0,0,9,2121,419,0,0
09/20/2020,553,0,0,6,2127,511,0,0
11/16/2020,735,0,0,7,2121,429,0,0
07/26/2020,553,0,0,7,2118,400,0,0
10/15/2020,744,0,0,3,2109,599,0,0
08/13/2020,700,0,0,9,2215,881,0,0
09-08-2020,551,0,0,7,2124,960,0,0
12-12-2020,113,0,0,4,2215,439,0,0
11/16/2020,743,0,0,4,2115,400,0,0
12-04-2020,554,0,0,12,2131,419,0,0
09/30/2020,735,0,0,9,2130,429,0,0
09-01-2020,745,0,0,4,2118,429,0,0
10/18/2020,500,0,0,8,2124,429,0,0
09/24/2020,745,0,0,3,2110,400,0,0
09-10-2020,745,0,0,6,2127,210,0,0
10/21/2020,900,0,0,8,2124,888,0,0
11/26/2020,553,0,0,6,2118,900,0,0
07/23/2020,113,0,0,6,2127,340,0,0
08-06-2020,714,0,0,6,2127,400,0,0
12-10-2020,735,0,0,9,2130,400,0,0
11/25/2020,113,0,0,12,2136,321,0,0
09-12-2020,511,0,0,4,2199,963,0,0
12-04-2020,113,0,0,7,2118,439,0,0
08/14/2020,600,0,0,4,2116,900,0,0
07/29/2020,550,0,0,11,2135,900,0,0
07/27/2020,553,0,0,4,2115,900,0,0
10-08-2020,553,0,0,7,2119,900,0,0
12/20/2020,651,0,0,4,2115,429,0,0
12/17/2020,733,0,0,11,2135,459,0,0
11-09-2020,554,0,0,6,2127,419,0,0
11/21/2020,542,0,0,11,2135,965,0,0
12-11-2020,714,0,0,12,2136,419,0,0
08-05-2020,735,0,0,12,2136,599,0,0
11/29/2020,553,0,0,6,2127,429,0,0
11-12-2020,735,0,0,12,2136,429,0,0
11-05-2020,553,0,0,4,2111,960,0,0
09/21/2020,743,0,0,12,2136,400,0,0
11/25/2020,553,0,0,3,2108,900,0,0
07/21/2020,554,0,0,8,2126,400,0,0
09/21/2020,735,0,0,7,2122,500,0,0
08/30/2020,745,0,0,9,2119,400,0,0
08/21/2020,553,0,0,7,2124,963,0,0
09/19/2020,622,0,0,4,2118,900,0,0
10-11-2020,400,0,0,8,2122,419,0,0
07/27/2020,413,0,0,1,2128,960,0,0
12/25/2020,715,0,0,7,2125,429,0,0
07/28/2020,715,0,0,9,2119,400,0,0
08/15/2020,745,0,0,3,2110,500,0,0
10-10-2020,553,0,0,8,2124,429,0,0
07-05-2020,113,0,0,7,2121,429,0,0
08/20/2020,745,0,0,3,2110,500,0,0
11/21/2020,736,0,0,11,2135,419,0,0
10/22/2020,746,0,0,11,2135,429,0,0
08/30/2020,500,0,0,11,2135,963,0,0
09/14/2020,651,0,0,1,2128,961,0,0
09/22/2020,151,0,0,3,2113,963,0,0
08/26/2020,500,0,0,12,2136,400,0,0
11/15/2020,554,0,0,4,2118,400,0,0
10-11-2020,553,0,0,9,2130,400,0,0
07/28/2020,552,0,0,11,2135,962,0,0
09/22/2020,734,0,0,9,2119,211,0,0
09-01-2020,424,0,0,7,2122,429,0,0
10-07-2020,511,0,0,4,2118,960,0,0
12/31/2020,733,0,0,7,2122,419,0,0
07/20/2020,735,0,0,4,2118,429,0,0
09-05-2020,745,0,0,6,2210,599,0,0
07/18/2020,500,0,0,3,2114,963,0,0
07/29/2020,746,0,0,8,2124,429,0,0
09-12-2020,745,0,0,9,2121,429,0,0
08/27/2020,600,0,0,1,2128,400,0,0
09/25/2020,142,0,0,12,2136,419,0,0
07/18/2020,413,0,0,1,2128,900,0,0
07/15/2020,745,0,0,3,2113,161,0,0
11-10-2020,714,0,0,7,2121,131,0,0
10/16/2020,745,0,0,4,2118,429,0,0
09/14/2020,424,0,0,9,2130,429,0,0
08-04-2020,440,0,0,9,2119,400,0,0
10/17/2020,743,0,0,11,2135,429,0,0
10-02-2020,714,0,0,8,2126,429,0,0
09-12-2020,611,0,0,11,2134,419,0,0
12/23/2020,553,0,0,4,2111,900,0,0
09/29/2020,600,0,0,4,2215,429,0,0
07/28/2020,424,0,0,8,2126,419,0,0
12-10-2020,113,0,0,4,2116,429,0,0
12-04-2020,113,0,0,8,2121,140,0,0
09-10-2020,714,0,0,8,2126,429,0,0
12/16/2020,735,0,0,6,2127,429,0,0
08/30/2020,554,0,0,8,2124,419,0,0
08/18/2020,600,0,0,4,2115,900,0,0
11-12-2020,715,0,0,3,2113,960,0,0
08/21/2020,651,0,0,12,2136,419,0,0
10-03-2020,500,0,0,11,2135,419,0,0
12/16/2020,743,0,0,4,2111,569,0,0
11-12-2020,745,0,0,1,2128,123,0,0
10/30/2020,735,0,0,1,2128,922,0,0
08-04-2020,553,0,0,12,2132,962,0,0
07/13/2020,143,100,0,12,2131,900,100,0
12-09-2020,715,0,0,4,2118,400,0,0
10/20/2020,553,0,0,4,2118,400,0,0
07/31/2020,554,0,0,3,2113,429,0,0
10/18/2020,500,0,0,4,2115,400,0,0
08/23/2020,553,0,0,7,2119,962,0,0
10/23/2020,715,0,0,12,2130,419,0,0
09-06-2020,600,0,0,3,2114,400,0,0
09/14/2020,113,0,0,12,2136,161,0,0
12-03-2020,522,0,0,11,2135,429,0,0
07/23/2020,522,0,0,1,2128,961,0,0
12/14/2020,154,0,0,3,2129,960,0,0
09/17/2020,400,0,0,8,2122,962,0,0
09/14/2020,113,0,0,9,2130,439,0,0
09-03-2020,552,0,0,8,2126,900,0,0
11-05-2020,410,0,0,12,2132,400,0,0
12/18/2020,113,0,0,9,2119,429,0,0
09/23/2020,113,0,0,9,2115,340,0,0
09-03-2020,600,0,0,8,2122,965,0,0
08/24/2020,745,0,0,4,2111,400,0,0
08-04-2020,553,0,0,1,2128,419,0,0
08-04-2020,600,0,0,12,2131,960,0,0
09/26/2020,553,0,0,6,2127,900,0,0
10-07-2020,813,0,0,11,2134,962,0,0
10-08-2020,553,0,0,9,2119,900,0,0
07-04-2020,652,0,0,4,2118,429,0,0
11/30/2020,736,0,0,11,2135,500,0,0
11-09-2020,745,0,0,4,2116,151,0,0
07/29/2020,600,0,0,4,2118,900,0,0
08/17/2020,553,0,0,9,2115,900,0,0
07/31/2020,142,0,0,12,2131,900,0,0
07-04-2020,151,0,0,7,2122,962,0,0
10/30/2020,553,0,0,4,2116,900,0,0
11/23/2020,600,0,0,9,2120,400,0,0
12-08-2020,744,0,0,8,2126,429,0,0
08/31/2020,743,0,0,4,2116,400,0,0
11-01-2020,733,0,0,4,2115,429,0,0
12/15/2020,745,0,0,9,2121,429,0,0
12-08-2020,440,0,0,6,2127,400,0,0
09/17/2020,652,0,0,4,2118,161,0,0
09-12-2020,714,0,0,4,2118,429,0,0
10/15/2020,745,0,0,3,2111,599,0,0
11-11-2020,712,0,0,9,2131,331,0,0
12/29/2020,553,0,0,12,2136,400,0,0
08/28/2020,113,0,0,12,2132,419,0,0
07-04-2020,743,0,0,12,2131,419,0,0
10-07-2020,743,0,0,3,2109,449,0,0
09/13/2020,553,0,0,7,2119,900,0,0
12/15/2020,714,0,0,4,2115,500,0,0
07/13/2020,160,0,0,3,2108,174,0,0
12-02-2020,554,0,0,11,2135,429,0,0
10/16/2020,743,0,0,3,2111,500,0,0
12/25/2020,400,0,0,7,2122,429,0,0
08-01-2020,600,0,0,9,2119,900,0,0
11/24/2020,553,0,0,4,2118,429,0,0
11-09-2020,553,0,0,9,2120,419,0,0
10/23/2020,553,0,0,9,2120,460,0,0
10/14/2020,522,0,0,9,2119,429,0,0
10/31/2020,745,0,0,4,2116,500,0,0
08/26/2020,553,0,0,7,2125,419,0,0
10-05-2020,113,0,0,8,2126,400,0,0
11-12-2020,500,0,0,7,2121,429,0,0
09/21/2020,745,0,0,11,2135,429,0,0
08/13/2020,745,0,0,6,2210,449,0,0
09/23/2020,736,0,0,11,2135,429,0,0
09/28/2020,735,0,0,9,2130,400,0,0
10/30/2020,444,0,0,4,2118,900,0,0
10/23/2020,714,0,0,12,2130,161,0,0
11-05-2020,743,0,0,4,2116,500,0,0
10-05-2020,741,0,0,4,2111,429,0,0
07/15/2020,553,0,0,9,2119,900,0,0
07/27/2020,113,0,0,9,2120,400,0,0
12/20/2020,113,0,0,4,2111,439,0,0
11/16/2020,411,0,0,8,2126,960,0,0
07-11-2020,553,0,0,1,2128,419,0,0
11-12-2020,700,0,0,4,2215,429,0,0
11/22/2020,745,0,0,7,2121,429,0,0
09/23/2020,745,0,0,4,2116,460,0,0
07/14/2020,744,0,0,8,2122,419,0,0
09/27/2020,745,0,0,3,2108,400,0,0
10/15/2020,412,0,0,3,2108,960,0,0
09/13/2020,551,0,0,9,2120,460,0,0
08-09-2020,714,0,0,3,2114,400,0,0
09/25/2020,735,0,0,11,2135,429,0,0
07-11-2020,151,0,0,11,2134,963,0,0
08/18/2020,641,0,0,9,2130,400,0,0
08/26/2020,500,0,0,6,2125,539,0,0
07/18/2020,553,0,0,4,2215,429,0,0
12-10-2020,714,0,0,4,2215,449,0,0
11/18/2020,736,0,0,9,2130,429,0,0
10/14/2020,551,0,0,12,2132,900,0,0
09/20/2020,715,0,0,3,2113,400,0,0
07/20/2020,745,0,0,4,2118,429,0,0
07/24/2020,745,0,0,3,2110,900,0,0
10/26/2020,554,0,0,12,2467,429,0,0
07-12-2020,442,0,0,4,2215,952,0,0
09-08-2020,552,0,0,11,2134,161,0,0
12-04-2020,553,0,0,11,2134,962,0,0
09/16/2020,116,0,0,7,2119,419,0,0
11/29/2020,743,0,0,3,2129,419,0,0
12/17/2020,553,0,0,8,2126,429,0,0
09/24/2020,553,0,0,6,2127,429,0,0
09/20/2020,553,0,0,9,2119,960,0,0
12/24/2020,113,0,50,9,2119,429,50,0
11-08-2020,733,0,0,4,2116,161,0,0
08/23/2020,745,0,0,11,2135,210,0,0
12-01-2020,553,0,0,1,2128,962,0,0
10-09-2020,600,0,0,7,2125,900,0,0
12-05-2020,554,0,0,11,2134,429,0,0
08/21/2020,600,0,0,4,2118,938,0,0
08-05-2020,745,0,0,6,2118,322,0,0
08-02-2020,621,0,0,3,2108,400,0,0
07-01-2020,552,0,0,11,2135,963,0,0
10/15/2020,553,0,0,11,2135,960,0,0
08/25/2020,714,0,0,9,2119,400,0,0
08-04-2020,714,0,0,9,2121,429,0,0
11/14/2020,500,0,0,12,2136,419,0,0
09/15/2020,745,0,0,11,2135,429,0,0
12-03-2020,600,0,0,9,2119,429,0,0
10/17/2020,711,0,0,4,2118,963,0,0
12-09-2020,113,0,0,9,2130,419,0,0
12/21/2020,743,0,0,4,2215,429,0,0
09/21/2020,740,0,0,4,2116,429,0,0
12-04-2020,622,0,0,1,2128,400,0,0
12/18/2020,735,0,0,4,2115,152,0,0
09-10-2020,715,0,0,8,2126,400,0,0
12/25/2020,511,0,0,6,2127,429,0,0
12/25/2020,600,0,0,7,2125,429,0,0
08-05-2020,611,0,0,8,2124,429,0,0
10/18/2020,600,0,0,8,2124,900,0,0
08/25/2020,745,0,0,9,2130,400,0,0
12-10-2020,740,0,0,4,2111,161,0,0
08/30/2020,424,0,0,8,2124,419,0,0
07/30/2020,553,0,0,9,2119,400,0,0
07/19/2020,714,0,0,6,2125,449,0,0
08-07-2020,733,0,0,1,2128,429,0,0
10/29/2020,500,0,0,11,2135,400,0,0
09/30/2020,733,0,0,3,2129,400,0,0
10/22/2020,500,0,0,4,2115,400,0,0
07-11-2020,553,0,0,4,2116,960,0,0
11/20/2020,600,0,0,8,2126,429,0,0
08-06-2020,444,0,0,9,2130,962,0,0
09/16/2020,445,0,0,9,2130,962,0,0
08-06-2020,600,0,0,4,2118,960,0,0
11/30/2020,553,0,0,7,2119,400,0,0
10/29/2020,621,0,0,6,2127,900,0,0
11-05-2020,743,0,0,4,2116,449,0,0
08/19/2020,714,0,0,7,2118,429,0,0
11/13/2020,733,0,0,8,2124,429,0,0
12/18/2020,500,0,0,3,2108,429,0,0
07-02-2020,733,0,0,7,2119,429,0,0
07-02-2020,740,0,0,9,2115,460,0,0
12-02-2020,736,0,0,3,2108,419,0,0
08/18/2020,700,0,0,9,2119,400,0,0
09/26/2020,714,0,0,7,2125,400,0,0
08/22/2020,745,0,0,4,2118,429,0,0
09/18/2020,113,0,50,11,2163,460,50,0
08-07-2020,554,0,0,12,2131,429,0,0
07-11-2020,743,0,0,3,2114,331,0,0
08/14/2020,553,0,0,7,2119,900,0,0
08/13/2020,553,0,0,4,2118,429,0,0
08/17/2020,553,0,0,4,2115,900,0,0
08/24/2020,743,0,0,9,2119,429,0,0
07/24/2020,600,0,0,9,2132,960,0,0
08-01-2020,715,0,0,4,2116,400,0,0
10-06-2020,600,0,0,6,2118,900,0,0
09/23/2020,553,0,0,6,2127,429,0,0
08/22/2020,743,0,0,4,2215,449,0,0
09/14/2020,733,0,0,9,2130,429,0,0
12/17/2020,444,0,0,6,2127,960,0,0
11-03-2020,413,0,0,7,2122,900,0,0
09/21/2020,733,0,0,9,2120,400,0,0
12-07-2020,715,0,0,9,2130,429,0,0
11/22/2020,553,0,0,6,2118,900,0,0
10/24/2020,733,0,0,9,2215,331,0,0
11/19/2020,553,0,0,4,2116,963,0,0
11/23/2020,600,0,0,8,2124,900,0,0
08-04-2020,553,0,0,4,2199,963,0,0
08-06-2020,440,0,0,8,2126,960,0,0
10/14/2020,553,0,0,1,2128,400,0,0
12/17/2020,522,0,0,8,2124,429,0,0
12/13/2020,553,0,0,7,2122,429,0,0
09/29/2020,553,0,0,7,2125,429,0,0
11/30/2020,553,0,0,11,2135,962,0,0
08/16/2020,714,0,0,9,2121,429,0,0
09-02-2020,553,0,0,9,2119,400,0,0
07/14/2020,714,0,0,12,2136,419,0,0
10-07-2020,600,0,0,1,2128,900,0,0
08/21/2020,554,0,0,1,2128,311,0,0
07/20/2020,553,0,0,12,2126,900,0,0
12-12-2020,116,0,0,8,2124,419,0,0
10/27/2020,112,0,0,9,2119,429,0,0
12/23/2020,500,0,0,9,2130,400,0,0
11/20/2020,600,0,0,12,2136,962,0,0
09/19/2020,553,0,0,12,2132,900,0,0
08/25/2020,553,0,0,8,2124,429,0,0
10/29/2020,743,0,0,9,2115,241,0,0
08/25/2020,622,0,0,3,2114,921,0,0
07/18/2020,142,0,0,8,2126,938,0,0
11/25/2020,550,0,0,7,2125,429,0,0
12/17/2020,600,0,0,8,2124,429,0,0
07-01-2020,735,0,0,4,2111,161,0,0
11-11-2020,553,0,0,4,2115,960,0,0
11/22/2020,553,0,0,4,2116,960,0,0
08-04-2020,553,0,0,7,2119,100,0,0
12/17/2020,745,0,0,3,2114,429,0,0
11-01-2020,154,0,0,4,2215,900,0,0
08-10-2020,611,0,0,9,2119,429,0,0
09-05-2020,553,0,0,4,2118,400,0,0
11-05-2020,736,0,0,4,2118,419,0,0
07/16/2020,553,0,0,3,2114,960,0,0
10/31/2020,652,0,0,8,2124,419,0,0
09/14/2020,151,0,0,9,2130,429,0,0
07-09-2020,553,0,0,12,2132,429,0,0
09/29/2020,651,0,0,4,2116,100,0,0
09-08-2020,735,0,0,9,2130,400,0,0
09-07-2020,511,0,0,7,2124,962,0,0
09/24/2020,712,0,0,4,2116,429,0,0
07/24/2020,553,0,0,4,2116,900,0,0
09/19/2020,745,0,0,8,2124,429,0,0
10-06-2020,500,0,0,7,2119,150,0,0
11-04-2020,511,0,0,4,2115,429,0,0
08/27/2020,652,0,0,1,2128,900,0,0
12-05-2020,553,0,0,9,2121,900,0,0
08/24/2020,600,0,0,8,2126,429,0,0
08-12-2020,554,0,0,1,2128,419,0,0
07/24/2020,553,0,0,4,2128,900,0,0
09/18/2020,553,0,0,7,2119,900,0,0
12-06-2020,700,0,0,8,2126,429,0,0
12/30/2020,746,0,0,6,2127,419,0,0
10/23/2020,744,0,0,3,2129,464,0,0
12/19/2020,554,0,0,8,2124,429,0,0
11/13/2020,554,0,0,11,2135,429,0,0
12/21/2020,746,0,0,7,2125,400,0,0
11-09-2020,715,0,0,6,2118,888,0,0
08/20/2020,745,0,0,3,2114,599,0,0
07-05-2020,154,0,0,4,2115,900,0,0
10/17/2020,735,0,0,6,2127,400,0,0
09/19/2020,745,0,0,9,2121,400,0,0
11-02-2020,743,0,0,6,2125,449,0,0
10/20/2020,553,0,0,6,2119,900,0,0
08-05-2020,745,0,0,4,2116,429,0,0
09/30/2020,440,0,0,9,2119,900,0,0
11-01-2020,733,0,0,4,2118,161,0,0
07-06-2020,553,0,0,4,2116,960,0,0
11/23/2020,113,0,400,3,2114,429,400,0
12/30/2020,714,0,0,6,2127,429,0,0
09-05-2020,714,0,0,4,2115,439,0,0
09/23/2020,511,0,0,9,2131,963,0,0
07-04-2020,522,0,0,7,2125,419,0,0
09/25/2020,715,0,0,7,2125,419,0,0
10/21/2020,554,0,0,11,2135,419,0,0
12-04-2020,600,0,0,12,2131,419,0,0
09-07-2020,553,0,0,7,2125,429,0,0
07-10-2020,600,0,0,7,2125,419,0,0
10/24/2020,714,0,0,3,2108,581,0,0
07-04-2020,554,0,0,8,2126,429,0,0
10-08-2020,600,0,0,4,2118,429,0,0
09/30/2020,735,0,0,4,2111,460,0,0
11/21/2020,735,0,0,9,2119,400,0,0
10-07-2020,444,0,0,12,2136,419,0,0
12/14/2020,113,0,0,11,2134,419,0,0
08/30/2020,440,0,0,6,2127,400,0,0
07/23/2020,553,0,0,8,2124,962,0,0
07-09-2020,735,0,0,11,2135,400,0,0
10/28/2020,600,0,0,3,2129,963,0,0
11/30/2020,553,0,0,9,2121,962,0,0
09-04-2020,511,0,0,3,2108,960,0,0
12-01-2020,735,0,0,4,2118,342,0,0
09-03-2020,553,0,0,4,2118,960,0,0
12/15/2020,553,0,0,9,2115,900,0,0
12/25/2020,553,0,0,4,2116,900,0,0
08/14/2020,731,0,0,12,2136,839,0,0
07/25/2020,151,0,0,6,2210,960,0,0
10/28/2020,113,0,0,9,2119,400,0,0
07/20/2020,735,0,0,3,2108,400,0,0
12/30/2020,730,0,0,6,2210,599,0,0
10/14/2020,511,0,0,6,2125,965,0,0
12-08-2020,600,0,0,6,2127,900,0,0
08-07-2020,735,0,0,7,2122,500,0,0
10-07-2020,553,0,0,1,2128,962,0,0
11/22/2020,113,0,0,11,2135,429,0,0
12/19/2020,745,0,0,9,2130,429,0,0
08/15/2020,743,0,0,11,2135,419,0,0
11/29/2020,745,0,0,8,2124,200,0,0
11-10-2020,743,0,0,7,2122,429,0,0
12-01-2020,600,0,0,6,2118,900,0,0
12/19/2020,611,0,0,7,2121,429,0,0
08-12-2020,743,0,0,1,2128,400,0,0
11-03-2020,745,0,0,9,2115,241,0,0
07-05-2020,154,0,1,1,2128,210,1,0
08-03-2020,651,0,0,11,2134,429,0,0
08/21/2020,744,0,0,7,2119,400,0,0
11/14/2020,745,0,0,9,2120,519,0,0
09/13/2020,553,0,0,8,2124,960,0,0
12/23/2020,745,0,0,4,2116,449,0,0
12/13/2020,553,0,0,6,2127,400,0,0
12/25/2020,745,0,0,11,2215,460,0,0
12-11-2020,714,0,0,4,2116,429,0,0
12/22/2020,553,0,0,9,2132,960,0,0
10-02-2020,745,0,0,6,2127,429,0,0
12-01-2020,745,0,0,4,2111,599,0,0
09-05-2020,551,0,0,7,2121,963,0,0
10-07-2020,553,0,0,12,2136,419,0,0
08/29/2020,711,0,0,7,2118,900,0,0
10/19/2020,735,0,0,9,2120,160,0,0
07-12-2020,600,0,0,3,2109,960,0,0
11-02-2020,600,0,0,8,2122,419,0,0
11/29/2020,711,0,0,3,2110,963,0,0
08-04-2020,554,0,0,3,2114,400,0,0
11/28/2020,553,0,0,3,2114,900,0,0
11/15/2020,511,0,0,7,2125,429,0,0
08/31/2020,734,0,0,1,2128,580,0,0
11/19/2020,700,0,0,4,2118,400,0,0
12-11-2020,600,0,0,9,2130,429,0,0
08/27/2020,745,0,0,4,2215,400,0,0
10/30/2020,553,0,0,11,2134,962,0,0
08/18/2020,711,0,0,12,2132,962,0,0
07/23/2020,553,0,0,3,2114,961,0,0
12/17/2020,600,0,0,7,2125,519,0,0
08-04-2020,553,0,0,9,2119,400,0,0
08-04-2020,745,0,0,9,2130,429,0,0
08/23/2020,553,0,0,12,2132,962,0,0
09-06-2020,745,0,0,11,2135,419,0,0
12/21/2020,600,0,0,4,2120,400,0,0
12/23/2020,743,0,0,11,2134,429,0,0
08/23/2020,745,0,0,12,2136,429,0,0
08/14/2020,553,0,0,3,2114,900,0,0
10/22/2020,552,0,0,9,2130,419,0,0
12/19/2020,714,0,0,3,2129,429,0,0
09/20/2020,143,0,0,4,2116,963,0,0
08/29/2020,554,0,0,12,2136,429,0,0
12/24/2020,714,0,0,4,2111,429,0,0
09/25/2020,151,0,0,3,2110,960,0,0
07-03-2020,745,0,0,7,2121,429,0,0
08/28/2020,745,0,0,4,2111,429,0,0
12-08-2020,711,0,0,8,2126,960,0,0
11/13/2020,736,0,0,6,2125,449,0,0
11-10-2020,712,0,0,3,2129,464,0,0
10/29/2020,743,0,0,6,2127,429,0,0
10-02-2020,743,0,0,4,2118,429,0,0
11/16/2020,745,0,0,3,2110,599,0,0
12/21/2020,113,0,0,4,2116,549,0,0
12-12-2020,554,0,0,4,2118,429,0,0
11-01-2020,553,0,0,1,2128,429,0,0
12/19/2020,424,0,0,12,2131,429,0,0
09/26/2020,745,0,0,7,2119,549,0,0
08/23/2020,700,0,0,9,2130,429,0,0
12-09-2020,553,0,0,3,2129,419,0,0
08-05-2020,700,0,0,9,2130,400,0,0
07/18/2020,424,0,0,6,2127,429,0,0
08-12-2020,553,0,0,3,2129,900,0,0
07/31/2020,442,0,0,4,2118,629,0,0
12-08-2020,651,0,0,6,2118,519,0,0
08/21/2020,650,0,0,3,2110,960,0,0
08/28/2020,553,0,0,12,2131,960,0,0
09/28/2020,733,0,0,8,2122,400,0,0
09/19/2020,550,0,0,6,2125,400,0,0
12/28/2020,113,0,0,8,2124,429,0,0
09-11-2020,553,0,0,11,2135,400,0,0
08/26/2020,553,0,0,9,2119,400,0,0
09/27/2020,118,0,50,9,2120,215,50,0
11-11-2020,553,0,0,11,2135,429,0,0
10-07-2020,714,0,0,7,2119,400,0,0
07/19/2020,745,0,0,3,2113,400,0,0
12/30/2020,745,0,0,4,2111,599,0,0
07/20/2020,735,0,0,11,2135,429,0,0
09-07-2020,735,0,0,3,2129,173,0,0
07/25/2020,413,0,0,1,2128,960,0,0
07/24/2020,745,0,0,9,2120,400,0,0
12/18/2020,552,0,0,7,2122,900,0,0
12/19/2020,522,0,0,6,2127,429,0,0
08/13/2020,500,0,0,4,2118,960,0,0
10-06-2020,900,0,0,7,2121,962,0,0
12/29/2020,743,0,0,9,2130,459,0,0
08-11-2020,714,0,0,12,2130,429,0,0
08-01-2020,151,0,0,7,2122,900,0,0
12/16/2020,735,0,0,11,2135,429,0,0
09/19/2020,653,0,0,6,2127,807,0,0
11/23/2020,142,0,0,9,2120,900,0,0
09-10-2020,553,0,0,4,2118,960,0,0
09-03-2020,736,0,0,3,2114,500,0,0
12-08-2020,511,0,0,4,2116,900,0,0
11/28/2020,160,0,0,1,2128,962,0,0
07/22/2020,743,0,0,9,2130,210,0,0
11-10-2020,652,0,0,11,2467,449,0,0
07/15/2020,621,0,0,7,2125,962,0,0
08/30/2020,551,0,0,3,2113,962,0,0
09/14/2020,553,0,0,11,2135,429,0,0
09-01-2020,113,0,0,9,2130,429,0,0
12/15/2020,735,0,0,4,2120,429,0,0
11-02-2020,746,0,0,3,2113,429,0,0
08/28/2020,745,0,0,11,2163,241,0,0
10-01-2020,552,0,0,4,2199,500,0,0
12/13/2020,745,0,0,1,2128,459,0,0
11/26/2020,113,0,0,8,2126,400,0,0
12/24/2020,743,0,0,9,2130,429,0,0
10/18/2020,714,0,0,3,2113,429,0,0
11/13/2020,553,0,0,9,2119,400,0,0
07/28/2020,553,0,0,3,2114,429,0,0
09/17/2020,553,0,0,7,2121,965,0,0
12/24/2020,553,0,0,3,2129,429,0,0
11/25/2020,746,0,0,6,2127,429,0,0
10/31/2020,743,0,0,9,2119,519,0,0
12/20/2020,743,0,0,9,2121,429,0,0
07-03-2020,553,0,0,9,2119,900,0,0
08/18/2020,522,0,0,7,2119,900,0,0
07/13/2020,714,0,0,9,2119,439,0,0
10/18/2020,553,0,0,9,2130,400,0,0
11/14/2020,715,0,0,9,2130,400,0,0
10-06-2020,746,0,0,7,2125,419,0,0
09-02-2020,711,0,0,7,2121,960,0,0
10/26/2020,745,0,0,4,2115,629,0,0
09-07-2020,113,0,0,3,2109,429,0,0
09/22/2020,641,0,0,8,2126,340,0,0
09-03-2020,715,0,0,8,2126,400,0,0
12-01-2020,500,0,0,11,2134,429,0,0
08/19/2020,711,0,0,4,2118,400,0,0
07/16/2020,735,0,0,4,2120,429,0,0
10/26/2020,600,0,0,12,2131,962,0,0
08-01-2020,743,0,0,6,2125,429,0,0
07-11-2020,424,0,0,7,2122,429,0,0
10/17/2020,745,0,0,6,2210,519,0,0
11/24/2020,743,0,0,9,2115,331,0,0
10/25/2020,743,0,0,9,2130,400,0,0
11-05-2020,745,0,0,8,2124,429,0,0
08/23/2020,552,0,0,7,2119,419,0,0
08/29/2020,553,0,0,7,2121,429,0,0
12/25/2020,712,0,0,9,2130,331,0,0
08/29/2020,412,0,0,12,2131,419,0,0
10/20/2020,400,0,0,9,2119,963,0,0
11-03-2020,113,0,0,4,2215,429,0,0
12-10-2020,553,0,0,4,2118,429,0,0
07/15/2020,553,0,0,11,2134,900,0,0
09/25/2020,743,0,0,9,2130,419,0,0
11/28/2020,714,0,0,12,2132,311,0,0
12/25/2020,600,0,0,4,2215,900,0,0
09/27/2020,553,0,0,9,2130,429,0,0
10/20/2020,714,0,0,6,2127,140,0,0
07/14/2020,735,0,0,4,2118,429,0,0
10/16/2020,733,0,0,8,2136,429,0,0
08/15/2020,553,0,0,4,2118,963,0,0
07-04-2020,554,0,0,6,2125,429,0,0
07/28/2020,733,0,0,11,2467,200,0,0
12/25/2020,651,0,0,4,2118,429,0,0
09-06-2020,553,0,0,4,2118,960,0,0
07-02-2020,553,0,0,12,2132,900,0,0
12-03-2020,745,0,0,3,2113,429,0,0
11-05-2020,113,0,0,3,2114,322,0,0
07/13/2020,600,0,0,11,2134,960,0,0
11/18/2020,611,0,0,12,2132,419,0,0
09-11-2020,743,0,0,8,2124,429,0,0
10-11-2020,735,0,0,8,2122,429,0,0
07/21/2020,600,0,0,6,2118,900,0,0
10-10-2020,735,0,0,11,2134,241,0,0
10/26/2020,714,0,0,4,2118,429,0,0
12-02-2020,743,0,0,11,2134,429,0,0
07/25/2020,552,0,0,9,2130,960,0,0
08/31/2020,552,0,0,7,2122,900,0,0
09/20/2020,142,0,0,7,2125,965,0,0
08-06-2020,553,0,0,9,2119,900,0,0
07-08-2020,714,0,0,11,2134,429,0,0
10-02-2020,743,0,0,4,2118,400,0,0
09-09-2020,735,0,0,7,2121,429,0,0
12/14/2020,553,0,0,9,2120,429,0,0
12/16/2020,714,0,0,9,2121,400,0,0
09/24/2020,733,0,0,6,2210,500,0,0
10-02-2020,652,0,0,4,2116,429,0,0
09/22/2020,735,0,0,7,2121,519,0,0
12/29/2020,553,0,0,6,2125,965,0,0
09/22/2020,745,0,0,7,2125,200,0,0
11/26/2020,553,0,0,3,2129,900,0,0
11-05-2020,743,0,0,7,2125,200,0,0
07-12-2020,553,0,0,4,2118,900,0,0
12-07-2020,553,0,0,4,2115,592,0,0
10/18/2020,553,0,0,4,2118,300,0,0
11/29/2020,653,0,0,6,2127,900,0,0
11/18/2020,730,0,0,9,2130,888,0,0
11-10-2020,500,0,0,8,2124,900,0,0
10/16/2020,736,0,0,6,2127,429,0,0
10-03-2020,745,0,0,3,2108,529,0,0
07/21/2020,735,0,0,3,2108,500,0,0
09-09-2020,118,0,0,3,2110,174,0,0
08/21/2020,745,0,0,4,2111,429,0,0
10-07-2020,444,0,0,12,2132,900,0,0
10-02-2020,745,0,0,7,2119,400,0,0
08/27/2020,743,0,0,4,2118,400,0,0
11/22/2020,553,0,0,1,2128,962,0,0
09/22/2020,735,0,0,11,2135,429,0,0
11/25/2020,553,0,0,8,2126,419,0,0
12/23/2020,745,0,0,9,2130,429,0,0
10/30/2020,745,0,0,6,2127,400,0,0
07/13/2020,113,0,0,12,2136,400,0,0
09-09-2020,553,0,0,7,2119,900,0,0
08/20/2020,553,0,0,9,2132,419,0,0
07/15/2020,424,0,0,8,2124,429,0,0
11-04-2020,424,0,0,11,2135,429,0,0
09-09-2020,553,0,0,6,2127,900,0,0
10-06-2020,600,0,0,7,2125,429,0,0
09/15/2020,735,0,0,9,2215,331,0,0
09-09-2020,733,0,0,9,2115,331,0,0
09-07-2020,113,0,0,11,2135,429,0,0
11/22/2020,553,0,0,4,2111,960,0,0
11-11-2020,736,0,0,4,2115,400,0,0
11/17/2020,735,0,0,9,2119,400,0,0
11/20/2020,553,0,0,6,2127,429,0,0
09-09-2020,745,0,0,7,2122,529,0,0
08/24/2020,733,0,0,4,2118,429,0,0
10/27/2020,113,0,25,8,2126,429,25,0
07/14/2020,735,0,0,12,2136,429,0,0
10/27/2020,745,0,0,8,2122,429,0,0
09/26/2020,553,0,0,7,2119,449,0,0
07/25/2020,150,0,0,12,2132,963,0,0
07/15/2020,553,0,0,4,2118,429,0,0
07/31/2020,553,0,0,3,2114,174,0,0
09/16/2020,553,0,0,12,2132,962,0,0
07/18/2020,733,0,0,7,2124,429,0,0
09-06-2020,714,0,0,8,2126,429,0,0
10-06-2020,745,0,0,4,2116,429,0,0
07/14/2020,113,0,0,4,2118,331,0,0
07-05-2020,746,0,0,11,2135,400,0,0
07-08-2020,743,0,0,7,2125,419,0,0
09/25/2020,142,0,0,3,2114,900,0,0
09-11-2020,511,0,0,1,2128,900,0,0
08-02-2020,143,0,0,9,2120,900,0,0
09/14/2020,651,0,0,4,2118,429,0,0
08/16/2020,745,0,0,1,2128,500,0,0
08/29/2020,711,0,0,4,2118,963,0,0
09/23/2020,553,0,0,3,2114,900,0,0
08-01-2020,745,0,0,7,2121,429,0,0
07/18/2020,745,0,0,6,2210,599,0,0
08/23/2020,733,0,0,3,2111,599,0,0
09-12-2020,714,0,0,7,2125,419,0,0
08/16/2020,745,0,0,11,2134,429,0,0
07/13/2020,715,0,0,8,2122,419,0,0
08/27/2020,743,0,0,9,2130,400,0,0
12/28/2020,552,0,0,9,2130,150,0,0
10/17/2020,735,0,0,7,2125,174,0,0
09/26/2020,142,0,0,6,2125,936,0,0
09-07-2020,600,0,0,6,2127,429,0,0
10-01-2020,553,0,0,11,2134,429,0,0
12-07-2020,554,0,0,9,2119,429,0,0
12/25/2020,745,0,0,7,2124,429,0,0
12/29/2020,745,0,0,4,2111,599,0,0
11-10-2020,553,0,0,12,2131,960,0,0
07/19/2020,553,0,0,3,2113,963,0,0
08-12-2020,553,0,0,3,2129,429,0,0
08/28/2020,745,0,0,8,2124,429,0,0
07/13/2020,142,0,0,9,2121,938,0,0
08-01-2020,424,0,0,7,2121,429,0,0
09/21/2020,553,0,0,3,2109,449,0,0
09/19/2020,744,0,0,11,2135,429,0,0
11/30/2020,743,0,0,9,2215,331,0,0
12-08-2020,651,0,0,4,2115,429,0,0
09-03-2020,553,0,0,12,2130,900,0,0
08-06-2020,743,0,0,3,2108,400,0,0
08/20/2020,553,0,0,12,2131,429,0,0
12-06-2020,712,0,0,7,2122,439,0,0
09/22/2020,736,0,0,8,2124,419,0,0
07/28/2020,400,0,0,9,2120,400,0,0
11-09-2020,553,0,0,4,2118,321,0,0
08-01-2020,600,0,0,4,2215,429,0,0
09/26/2020,711,0,0,12,2131,900,0,0
08/16/2020,113,0,0,12,2136,459,0,0
11/17/2020,553,0,0,9,2119,419,0,0
12/18/2020,522,0,0,6,2210,400,0,0
10/18/2020,552,0,0,6,2127,960,0,0
08/17/2020,554,0,0,1,2128,459,0,0
12-02-2020,424,0,0,1,2128,419,0,0
10-02-2020,113,0,0,12,2136,429,0,0
08/23/2020,743,0,0,9,2130,429,0,0
07/13/2020,622,0,0,8,2124,400,0,0
07-01-2020,553,0,0,4,2118,960,0,0
07/27/2020,712,0,0,8,2124,331,0,0
09/26/2020,553,0,0,6,2119,900,0,0
10-12-2020,735,0,0,1,2128,429,0,0
08/27/2020,113,0,0,11,2135,429,0,0
11-06-2020,113,0,0,4,2116,161,0,0
10-04-2020,500,0,0,3,2129,962,0,0
11/13/2020,735,0,0,7,2118,400,0,0
10/19/2020,113,0,50,11,2134,161,50,0
12-04-2020,745,0,0,4,2116,400,0,0
11/23/2020,745,0,0,7,2121,429,0,0
09-10-2020,743,0,0,11,2135,400,0,0
08/18/2020,113,0,0,4,2116,429,0,0
10/22/2020,745,0,0,4,2215,439,0,0
08/17/2020,745,0,0,3,2108,500,0,0
09/30/2020,715,0,0,11,2134,629,0,0
12/19/2020,743,0,0,11,2135,429,0,0
09/30/2020,553,0,0,9,2132,962,0,0
12/27/2020,542,0,0,6,2118,361,0,0
08-04-2020,745,0,0,11,2135,429,0,0
12-08-2020,735,0,0,7,2125,100,0,0
07/16/2020,113,0,0,8,2126,429,0,0
09/30/2020,745,0,0,7,2125,200,0,0
07-03-2020,600,0,0,4,2118,960,0,0
09/25/2020,113,0,0,3,2108,429,0,0
11/29/2020,743,0,0,12,2136,400,0,0
08-08-2020,411,0,0,7,2124,960,0,0
07/18/2020,162,0,0,7,2125,962,0,0
09/16/2020,714,0,0,4,2215,400,0,0
07/17/2020,743,0,0,6,2118,361,0,0
10-03-2020,113,0,0,4,2118,161,0,0
10-09-2020,735,0,0,4,2118,429,0,0
12-06-2020,743,0,0,11,2135,429,0,0
12/28/2020,553,0,0,12,2132,419,0,0
10/19/2020,500,0,0,12,2136,400,0,0
07/24/2020,553,0,0,7,2121,960,0,0
07-06-2020,743,0,0,9,2120,400,0,0
10/24/2020,553,0,0,6,2127,900,0,0
09-12-2020,554,0,0,7,2122,429,0,0
09/24/2020,650,0,0,7,2125,460,0,0
11/26/2020,553,0,0,7,2121,429,0,0
12/20/2020,740,0,0,9,2119,429,0,0
10/22/2020,553,0,0,4,2115,400,0,0
09/26/2020,553,0,0,6,2210,449,0,0
07/20/2020,733,0,0,3,2113,429,0,0
07-03-2020,553,0,0,9,2130,962,0,0
09/19/2020,511,0,0,12,2132,419,0,0
08/25/2020,553,0,0,4,2118,960,0,0
12-06-2020,553,0,0,3,2108,100,0,0
08/13/2020,700,0,0,9,2120,400,0,0
09/26/2020,500,0,0,7,2121,963,0,0
07/26/2020,553,0,0,3,2113,429,0,0
10-10-2020,743,0,0,9,2115,460,0,0
08/16/2020,553,0,0,12,2131,419,0,0
07-02-2020,553,0,0,3,2203,900,0,0
12/16/2020,413,0,0,8,2126,900,0,0
10/29/2020,745,0,0,3,2111,300,0,0
09/16/2020,735,0,0,8,2124,429,0,0
12/16/2020,735,0,0,11,2134,429,0,0
10/14/2020,744,0,0,4,2115,241,0,0
12-11-2020,424,0,0,11,2135,429,0,0
07-02-2020,118,0,0,8,2124,200,0,0
12/25/2020,411,0,0,6,2127,419,0,0
10/15/2020,444,0,0,8,2122,900,0,0
12-05-2020,520,0,0,9,2130,429,0,0
12/14/2020,554,0,0,11,2135,429,0,0
12/19/2020,553,0,0,11,2134,429,0,0
12/28/2020,440,0,0,11,2135,331,0,0
12/16/2020,743,0,0,1,2128,400,0,0
10-07-2020,511,0,0,9,2119,962,0,0
12/30/2020,745,0,0,4,2111,599,0,0
10-01-2020,552,0,0,4,2118,429,0,0
11-09-2020,553,0,0,7,2121,960,0,0
07/14/2020,733,0,0,8,2124,130,0,0
12/18/2020,550,0,0,8,2124,429,0,0
12-01-2020,522,0,0,9,2120,213,0,0
08/28/2020,600,0,0,4,2118,960,0,0
11/26/2020,743,0,0,11,2134,429,0,0
09/18/2020,743,0,0,7,2119,429,0,0
09-04-2020,745,0,0,11,2135,429,0,0
12/26/2020,551,0,0,7,2121,962,0,0
10-08-2020,743,0,0,12,2132,519,0,0
10/19/2020,735,0,0,3,2114,599,0,0
07/21/2020,735,0,0,6,2127,891,0,0
11/18/2020,745,0,0,8,2122,419,0,0
07-05-2020,553,0,0,3,2114,900,0,0
11-07-2020,522,0,0,4,2118,500,0,0
08-04-2020,445,0,0,7,2125,960,0,0
12-10-2020,553,0,0,8,2126,900,0,0
12/30/2020,442,0,0,3,2114,519,0,0
09/29/2020,553,0,0,7,2119,900,0,0
09/21/2020,743,0,0,9,2120,400,0,0
12/17/2020,500,0,0,11,2135,429,0,0
12/16/2020,553,0,0,1,2128,419,0,0
08/23/2020,553,0,0,4,2116,960,0,0
12-05-2020,553,0,0,1,2128,429,0,0
11-08-2020,743,0,0,3,2109,400,0,0
07/29/2020,412,0,0,4,2118,419,0,0
09/25/2020,735,0,0,6,2127,254,0,0
08-04-2020,743,0,0,8,2124,419,0,0
08/21/2020,554,0,0,8,2121,400,0,0
09-07-2020,600,0,0,8,2124,500,0,0
07/17/2020,442,0,0,9,2115,331,0,0
11/17/2020,553,0,0,6,2118,963,0,0
09/19/2020,111,0,0,8,2124,429,0,0
08-04-2020,553,0,0,9,2130,900,0,0
10/19/2020,743,0,0,7,2125,419,0,0
10-12-2020,746,0,0,11,2135,400,0,0
10-05-2020,553,0,0,6,2127,931,0,0
12-03-2020,552,0,0,3,2110,174,0,0
11-09-2020,600,0,0,4,2118,429,0,0
11/30/2020,711,0,0,9,2130,963,0,0
07/26/2020,600,0,0,9,2132,131,0,0
09-06-2020,511,0,0,3,2113,419,0,0
12-06-2020,600,0,0,3,2108,439,0,0
07-11-2020,735,0,0,9,2130,331,0,0
12/24/2020,550,0,0,4,2118,960,0,0
10/16/2020,743,0,0,6,2125,581,0,0
07-04-2020,714,0,0,9,2119,322,0,0
07-07-2020,733,0,0,7,2125,429,0,0
11/16/2020,735,0,0,8,2124,429,0,0
10/17/2020,113,0,0,12,2131,419,0,0
11-07-2020,551,0,0,6,2127,960,0,0
09/21/2020,150,0,0,11,2134,963,0,0
11-09-2020,700,0,0,6,2125,960,0,0
08/29/2020,745,0,0,7,2122,429,0,0
08/16/2020,600,0,0,8,2124,131,0,0
07/20/2020,745,0,0,6,2127,254,0,0
10-05-2020,743,0,0,12,2132,161,0,0
11-03-2020,553,0,0,3,2129,700,0,0
11/22/2020,733,0,0,7,2119,400,0,0
12/20/2020,714,0,0,3,2129,429,0,0
08/28/2020,500,0,0,3,2111,900,0,0
09-01-2020,553,0,0,11,2135,429,0,0
07-04-2020,440,0,0,12,2131,960,0,0
12/25/2020,641,0,0,7,2121,500,0,0
07/14/2020,113,0,0,7,2125,429,0,0
08-01-2020,735,0,0,7,2119,400,0,0
10-05-2020,413,0,0,4,2118,400,0,0
12/29/2020,113,0,0,4,2215,400,0,0
08-01-2020,745,0,0,9,2130,459,0,0
08/22/2020,552,0,0,11,2135,965,0,0
10-08-2020,714,0,0,4,2116,429,0,0
09/20/2020,600,0,0,9,2119,963,0,0
09/16/2020,700,0,0,4,2118,400,0,0
08-01-2020,745,0,0,12,2126,629,0,0
09/23/2020,553,0,0,6,2127,429,0,0
07/21/2020,553,0,0,3,2129,429,0,0
11/13/2020,745,0,0,7,2122,644,0,0
08-04-2020,600,0,0,7,2121,429,0,0
08/17/2020,711,0,0,9,2121,960,0,0
09/29/2020,424,0,0,8,2126,419,0,0
10/23/2020,745,0,0,4,2118,429,0,0
12/26/2020,735,0,0,11,2134,429,0,0
07/16/2020,551,0,0,7,2121,963,0,0
12/24/2020,512,0,0,11,2135,100,0,0
11-09-2020,511,0,0,9,2121,965,0,0
07-12-2020,143,0,0,1,2128,900,0,0
09/22/2020,113,0,0,7,2122,429,0,0
12/28/2020,551,0,0,7,2119,960,0,0
07-09-2020,553,0,0,7,2119,931,0,0
12/31/2020,553,0,0,12,2131,400,0,0
07/21/2020,745,0,0,7,2125,429,0,0
08-11-2020,743,0,0,3,2114,500,0,0
12/14/2020,113,0,0,1,2128,519,0,0
08-04-2020,600,0,0,12,2131,419,0,0
09-01-2020,510,0,0,4,2118,963,0,0
12/30/2020,553,0,0,9,2130,311,0,0
11/28/2020,745,0,0,4,2116,449,0,0
12/24/2020,743,0,0,9,2130,429,0,0
07/13/2020,113,0,0,9,2215,331,0,0
12-09-2020,440,0,0,6,2127,400,0,0
11/28/2020,553,0,0,9,2121,429,0,0
07/28/2020,413,0,0,8,2122,962,0,0
08-04-2020,553,0,0,7,2125,962,0,0
10/15/2020,553,0,0,6,2127,429,0,0
08-02-2020,151,0,0,3,2109,900,0,0
07-12-2020,553,0,0,6,2125,429,0,0
12/25/2020,745,0,0,8,2124,429,0,0
10-09-2020,744,0,0,6,2127,400,0,0
08/29/2020,113,0,0,4,2118,429,0,0
09-07-2020,142,0,0,6,2125,960,0,0
09-12-2020,522,0,0,3,2113,419,0,0
12/14/2020,500,0,0,12,2136,429,0,0
08/17/2020,113,0,0,6,2127,429,0,0
10-08-2020,600,0,0,8,2131,960,0,0
08-02-2020,553,0,0,12,2136,962,0,0
08/24/2020,746,0,0,11,2134,429,0,0
08-12-2020,113,0,0,6,2125,429,0,0
10/25/2020,553,0,0,9,2119,429,0,0
08/18/2020,711,0,0,12,2132,962,0,0
12/21/2020,441,0,0,4,2111,429,0,0
10/16/2020,745,0,0,3,2129,500,0,0
12/25/2020,743,0,0,4,2116,400,0,0
08-08-2020,411,0,0,11,2135,900,0,0
09/15/2020,745,0,0,4,2118,439,0,0
08/21/2020,500,0,0,4,2215,400,0,0
12-04-2020,553,0,0,1,2128,900,0,0
10-04-2020,552,0,0,4,2215,400,0,0
07-04-2020,113,0,0,8,2124,429,0,0
07-12-2020,554,0,0,12,2136,419,0,0
10/13/2020,400,0,0,1,2128,962,0,0
11-08-2020,746,0,0,9,2130,419,0,0
07/19/2020,553,0,0,4,2118,439,0,0
10/28/2020,711,0,0,7,2119,900,0,0
10/29/2020,553,0,0,4,2111,900,0,0
12/18/2020,735,0,0,8,2124,429,0,0
08-12-2020,111,0,0,7,2125,564,0,0
09/30/2020,553,0,0,12,2132,962,0,0
07/21/2020,744,0,0,9,2119,429,0,0
07-10-2020,511,0,0,1,2128,962,0,0
07/13/2020,600,0,0,12,2131,960,0,0
10-07-2020,746,0,0,12,2131,400,0,0
12/21/2020,531,0,0,4,2118,460,0,0
12-03-2020,553,0,0,12,2132,419,0,0
10/21/2020,715,0,0,12,2132,419,0,0
12/27/2020,745,0,0,7,2124,429,0,0
09/23/2020,511,0,0,9,2130,960,0,0
09/21/2020,553,0,0,8,2122,962,0,0
10/18/2020,743,0,0,8,2126,400,0,0
12-03-2020,553,0,0,4,2118,900,0,0
10/15/2020,745,0,0,9,2115,241,0,0
11-08-2020,553,0,0,8,2124,429,0,0
12/25/2020,735,0,0,4,2215,981,0,0
10/22/2020,735,0,0,1,2128,400,0,0
12-03-2020,600,0,0,12,2132,419,0,0
12/18/2020,554,0,0,9,2130,419,0,0
10/15/2020,151,0,0,7,2125,900,0,0
08/24/2020,461,0,0,7,2121,429,0,0
08/17/2020,113,0,35,11,2135,429,35,0
11-07-2020,113,0,0,9,2115,460,0,0
12/24/2020,740,0,0,9,2130,331,0,0
07/29/2020,553,0,0,4,2199,419,0,0
07-03-2020,552,0,0,4,2116,963,0,0
10-02-2020,735,0,0,8,2124,429,0,0
11/30/2020,553,0,0,8,2124,960,0,0
12-06-2020,113,0,0,12,2136,429,0,0
12-05-2020,735,0,0,6,2210,599,0,0
11-03-2020,745,0,0,6,2127,429,0,0
10/13/2020,511,0,0,8,2126,429,0,0
08-05-2020,553,0,0,3,2109,549,0,0
10/17/2020,142,0,0,9,2130,900,0,0
09-05-2020,746,0,0,4,2116,400,0,0
09/21/2020,600,0,0,4,2116,900,0,0
08/16/2020,151,0,0,7,2127,951,0,0
11/27/2020,553,0,0,3,2108,900,0,0
10-10-2020,600,0,0,8,2124,300,0,0
09/30/2020,600,0,0,12,2132,419,0,0
09/20/2020,553,0,0,7,2121,429,0,0
07/14/2020,600,0,0,3,2114,960,0,0
08/15/2020,600,0,0,1,2128,960,0,0
09-06-2020,553,0,0,7,2125,963,0,0
08/27/2020,735,0,0,4,2116,460,0,0
11/24/2020,553,0,0,6,2127,429,0,0
08/16/2020,715,0,0,9,2119,419,0,0
09-02-2020,113,0,0,8,2124,429,0,0
08/23/2020,733,0,0,9,2130,429,0,0
11-08-2020,600,0,0,3,2108,100,0,0
11-06-2020,553,0,0,11,2135,962,0,0
07/22/2020,553,0,0,12,2132,965,0,0
11-07-2020,422,0,0,8,2124,900,0,0
09/28/2020,411,0,0,12,2132,962,0,0
09-02-2020,600,0,0,7,2125,960,0,0
07-01-2020,600,0,0,9,2130,900,0,0
09/25/2020,113,0,0,11,2134,429,0,0
09/26/2020,715,0,0,6,2127,429,0,0
10/28/2020,553,0,0,7,2118,439,0,0
12-11-2020,735,0,0,1,2128,419,0,0
10/25/2020,734,0,0,4,2115,400,0,0
10/15/2020,553,0,0,3,2114,331,0,0
08/30/2020,113,0,0,11,2135,419,0,0
09-06-2020,113,0,0,7,2121,429,0,0
07-08-2020,740,0,0,9,2120,429,0,0
10/18/2020,745,0,0,4,2116,500,0,0
08/18/2020,142,0,0,12,2136,965,0,0
08-05-2020,745,0,0,6,2210,429,0,0
09-10-2020,600,0,0,4,2215,900,0,0
12/31/2020,714,0,0,4,2199,500,0,0
10/20/2020,652,0,0,1,2128,429,0,0
09/19/2020,736,0,0,1,2128,400,0,0
11/19/2020,554,0,0,9,2115,429,0,0
07/16/2020,553,0,0,7,2119,429,0,0
08-12-2020,553,0,0,7,2121,960,0,0
09-11-2020,554,0,0,12,2136,419,0,0
09/24/2020,745,0,0,3,2129,429,0,0
07/23/2020,440,0,0,4,2115,429,0,0
07/25/2020,400,0,0,9,2130,960,0,0
07-02-2020,600,0,0,6,2127,963,0,0
10/22/2020,715,0,0,6,2127,400,0,0
09/20/2020,600,0,0,11,2134,429,0,0
08-04-2020,743,0,0,1,2128,429,0,0
11/17/2020,553,0,0,3,2110,900,0,0
09/21/2020,715,0,0,3,2108,500,0,0
10/28/2020,735,0,0,6,2127,419,0,0
10/22/2020,745,0,0,7,2125,429,0,0
12-12-2020,715,0,0,9,2130,429,0,0
10/28/2020,711,0,0,12,2132,962,0,0
11/19/2020,714,0,0,6,2127,429,0,0
11/21/2020,745,0,0,4,2116,429,0,0
11/15/2020,715,0,0,7,2121,400,0,0
09/29/2020,743,0,0,9,2130,429,0,0
09/23/2020,621,0,0,4,2118,960,0,0
11/29/2020,736,0,0,8,2124,419,0,0
11-12-2020,743,0,0,12,2132,429,0,0
08/22/2020,553,0,0,9,2130,962,0,0
09-01-2020,440,0,0,11,2135,962,0,0
08-05-2020,553,0,0,6,2127,400,0,0
12/31/2020,745,0,0,9,2119,429,0,0
08-10-2020,551,0,0,3,2109,900,0,0
09-05-2020,553,0,0,3,2114,900,0,0
09-05-2020,553,0,0,4,2118,429,0,0
12-12-2020,550,0,0,3,2129,419,0,0
09/13/2020,552,0,0,9,2130,429,0,0
08-01-2020,710,0,0,4,2116,429,0,0
10-05-2020,900,0,0,9,2130,331,0,0
08-09-2020,440,0,0,9,2130,419,0,0
12-08-2020,500,0,0,11,2135,962,0,0
11/23/2020,400,0,0,12,2132,900,0,0
10/26/2020,553,0,0,4,2118,960,0,0
11-06-2020,500,0,0,4,2118,960,0,0
10-06-2020,714,0,0,4,2215,241,0,0
09/25/2020,740,0,0,4,2118,429,0,0
09/23/2020,600,0,0,12,2132,419,0,0
11-02-2020,551,0,0,6,2127,960,0,0
08/24/2020,735,0,0,8,2126,429,0,0
07/24/2020,553,0,0,8,2122,962,0,0
12-03-2020,745,0,0,8,2124,429,0,0
09-10-2020,714,0,0,7,2121,429,0,0
10-10-2020,550,0,0,12,2131,900,0,0
08/29/2020,700,0,0,6,2127,429,0,0
07/20/2020,745,0,0,4,2111,173,0,0
11/27/2020,600,0,0,8,2124,429,0,0
09/17/2020,744,0,0,11,2135,419,0,0
08/14/2020,413,0,0,7,2124,960,0,0
07/20/2020,553,0,0,9,2119,300,0,0
09/18/2020,113,0,0,4,2118,429,0,0
11-11-2020,611,0,0,8,2126,419,0,0
10/22/2020,553,0,0,3,2129,419,0,0
09-06-2020,710,0,0,6,2127,429,0,0
09/23/2020,553,0,0,4,2118,400,0,0
12/18/2020,424,0,0,12,2130,429,0,0
07/17/2020,553,0,0,7,2119,500,0,0
11/29/2020,553,0,0,8,2122,429,0,0
11-09-2020,600,0,0,4,2118,960,0,0
08-01-2020,553,0,0,4,2118,429,0,0
07/16/2020,142,0,0,11,2135,965,0,0
11-10-2020,600,0,0,6,2118,963,0,0
12/21/2020,652,0,0,4,2115,429,0,0
09-01-2020,553,0,0,9,2119,429,0,0
08-09-2020,743,0,0,6,2125,449,0,0
09-03-2020,553,0,0,9,2121,960,0,0
12/15/2020,714,0,0,4,2116,500,0,0
10-01-2020,743,0,0,11,2134,429,0,0
12/30/2020,553,0,0,8,2126,960,0,0
08/19/2020,553,0,0,4,2215,429,0,0
10/24/2020,733,0,0,8,2126,254,0,0
11/18/2020,743,0,0,11,2135,429,0,0
08-01-2020,600,0,0,11,2135,419,0,0
12-10-2020,740,0,0,9,2215,965,0,0
10/15/2020,743,0,0,8,2126,429,0,0
10/23/2020,745,0,0,9,2130,429,0,0
11/15/2020,600,0,0,4,2199,900,0,0
07-08-2020,652,0,0,9,2120,429,0,0
11/23/2020,522,0,0,9,2130,419,0,0
12/15/2020,745,0,0,7,2121,429,0,0
09/22/2020,715,0,0,9,2130,400,0,0
08/25/2020,600,0,0,3,2210,963,0,0
07/14/2020,743,0,0,3,2129,419,0,0
11-05-2020,713,0,0,7,2119,500,0,0
08/14/2020,553,0,0,11,2135,400,0,0
12/23/2020,733,0,0,8,2122,419,0,0
09-07-2020,740,0,0,7,2122,500,0,0
12/31/2020,553,0,0,4,2215,429,0,0
09/21/2020,745,0,0,8,2124,429,0,0
11/29/2020,500,0,0,9,2130,900,0,0
10/28/2020,553,0,0,4,2115,400,0,0
07/21/2020,553,0,0,4,2118,460,0,0
10-07-2020,553,0,0,1,2128,960,0,0
07-11-2020,551,0,0,9,2120,429,0,0
09/16/2020,736,0,0,4,2118,419,0,0
07/16/2020,553,0,0,6,2127,460,0,0
11/29/2020,511,0,0,1,2128,962,0,0
10/30/2020,735,0,0,6,2127,429,0,0
09/21/2020,746,0,0,7,2119,400,0,0
11-05-2020,745,0,0,9,2131,300,0,0
11-03-2020,733,0,0,4,2116,429,0,0
11/26/2020,113,0,0,6,2125,429,0,0
08-01-2020,730,0,0,1,2128,429,0,0
09/18/2020,745,0,0,9,2130,311,0,0
08/27/2020,553,0,0,12,2132,400,0,0
08/27/2020,553,0,0,4,2116,400,0,0
12-12-2020,745,0,0,4,2118,429,0,0
11/15/2020,444,0,0,12,2136,962,0,0
11/13/2020,511,0,0,8,2124,960,0,0
08/29/2020,733,0,0,12,2131,429,0,0
08/17/2020,552,0,0,1,2128,429,0,0
12-09-2020,413,0,0,4,2118,960,0,0
12/26/2020,714,0,0,12,2136,321,0,0
08/26/2020,553,0,0,8,2124,439,0,0
11/18/2020,715,0,0,4,2116,400,0,0
12/19/2020,553,0,0,3,2114,962,0,0
12/20/2020,113,0,0,9,2120,460,0,0
12-11-2020,113,0,0,7,2125,429,0,0
08-10-2020,143,0,0,1,2128,900,0,0
12-02-2020,553,0,0,8,2124,900,0,0
07-04-2020,553,0,0,11,2135,960,0,0
12/24/2020,746,0,0,7,2119,400,0,0
08-02-2020,553,0,0,1,2128,340,0,0
12-10-2020,554,0,0,12,2131,965,0,0
09/24/2020,735,0,0,11,2215,429,0,0
10/16/2020,113,0,0,7,2122,100,0,0
10/31/2020,113,0,50,11,2134,429,50,0
10/14/2020,511,0,0,6,2127,429,0,0
12/18/2020,714,0,0,4,2115,429,0,0
12-06-2020,554,0,0,8,2124,429,0,0
07-11-2020,743,0,0,6,2127,419,0,0
07/20/2020,746,0,0,1,2128,429,0,0
07-12-2020,554,0,0,7,2125,429,0,0
07-09-2020,733,0,0,8,2124,429,0,0
07/26/2020,746,0,0,9,2130,429,0,0
09/15/2020,745,0,0,11,2163,241,0,0
10/22/2020,511,0,0,9,2121,965,0,0
07/29/2020,743,0,0,3,2108,599,0,0
09/20/2020,553,0,0,12,2136,962,0,0
12/19/2020,743,0,0,9,2130,400,0,0
11/27/2020,735,0,0,6,2127,400,0,0
08/18/2020,700,0,0,4,2118,300,0,0
08-04-2020,553,0,0,7,2125,962,0,0
07-01-2020,553,0,0,7,2121,419,0,0
11/30/2020,444,0,0,12,2136,419,0,0
11/22/2020,113,0,0,11,2135,429,0,0
12/23/2020,652,0,0,1,2128,429,0,0
08/14/2020,735,0,0,7,2119,429,0,0
12-12-2020,600,0,0,7,2125,400,0,0
07-04-2020,118,0,0,9,2130,124,0,0
07-12-2020,511,5,0,7,2122,592,5,0
07/29/2020,413,0,0,7,2125,960,0,0
07-11-2020,553,0,0,7,2125,400,0,0
12-12-2020,745,0,0,9,2130,460,0,0
09/27/2020,743,0,0,11,2134,519,0,0
11/23/2020,735,0,0,4,2116,429,0,0
07/20/2020,553,0,0,12,2132,900,0,0
10/23/2020,745,0,0,1,2128,579,0,0
08/13/2020,743,0,0,3,2108,500,0,0
09/16/2020,733,0,0,7,2125,429,0,0
11/19/2020,554,0,0,11,2135,429,0,0
08-11-2020,553,0,0,12,2132,429,0,0
12-06-2020,715,0,0,9,2121,429,0,0
12/28/2020,611,0,0,8,2126,429,0,0
12-03-2020,553,0,0,12,2130,900,0,0
09-05-2020,711,0,0,4,2111,900,0,0
12-11-2020,554,0,0,1,2128,419,0,0
11-12-2020,522,0,0,6,2210,429,0,0
09/29/2020,553,0,0,6,2127,400,0,0
09/30/2020,553,0,0,4,2118,900,0,0
11/19/2020,442,0,0,11,2134,213,0,0
08-11-2020,735,0,0,3,2129,429,0,0
08-12-2020,553,0,0,4,2199,900,0,0
10-06-2020,600,0,0,11,2134,429,0,0
09/13/2020,745,0,0,7,2121,429,0,0
07-08-2020,736,0,0,7,2119,400,0,0
12-10-2020,743,0,0,3,2110,131,0,0
08-11-2020,552,0,0,4,2115,900,0,0
07/21/2020,600,0,0,3,2129,900,0,0
07-08-2020,745,0,0,4,2116,500,0,0
11-04-2020,552,0,0,1,2128,960,0,0
07/17/2020,744,0,0,4,2116,131,0,0
10-07-2020,551,0,0,3,2114,963,0,0
09-01-2020,736,0,0,9,2130,400,0,0
07/19/2020,715,0,0,7,2125,429,0,0
07/29/2020,745,0,0,3,2129,500,0,0
10-08-2020,600,0,0,4,2116,429,0,0
12-05-2020,553,0,0,3,2129,963,0,0
11/30/2020,736,0,0,12,2136,419,0,0
10-02-2020,651,0,0,12,2136,962,0,0
07/30/2020,553,0,0,12,2131,963,0,0
07-06-2020,745,0,0,7,2121,429,0,0
08/14/2020,500,0,0,12,2136,419,0,0
10/29/2020,424,0,0,3,2129,114,0,0
10/25/2020,743,0,0,4,2116,161,0,0
10-03-2020,553,0,0,3,2129,419,0,0
11-04-2020,553,0,0,1,2128,960,0,0
10/22/2020,600,0,0,4,2115,459,0,0
10/17/2020,733,0,0,8,2126,429,0,0
10-11-2020,733,0,0,3,2114,400,0,0
11/28/2020,553,0,0,8,2122,400,0,0
11/17/2020,745,0,0,11,2215,241,0,0
07/29/2020,745,0,0,3,2129,419,0,0
11/20/2020,715,0,0,4,2118,439,0,0
10/29/2020,500,0,0,8,2122,150,0,0
10/31/2020,715,0,0,7,2122,419,0,0
08/17/2020,553,0,0,7,2125,419,0,0
12/29/2020,553,0,0,11,2134,429,0,0
11-08-2020,745,0,0,12,2131,400,0,0
10/28/2020,411,0,0,7,2125,962,0,0
08/24/2020,554,0,0,11,2135,400,0,0
10/18/2020,210,0,0,9,2130,400,0,0
09/20/2020,745,0,0,12,2131,429,0,0
09-03-2020,440,0,0,12,2131,900,0,0
11/30/2020,113,0,0,3,2129,400,0,0
08/20/2020,553,0,0,6,2127,400,0,0
11-07-2020,553,0,0,12,2136,938,0,0
11-12-2020,733,0,0,9,2120,429,0,0
10-07-2020,553,0,0,12,2136,571,0,0
10-12-2020,554,0,0,4,2115,429,0,0
07-12-2020,553,0,0,6,2118,900,0,0
12-08-2020,733,0,0,3,2113,429,0,0
09-04-2020,554,0,0,8,2124,400,0,0
12/14/2020,154,0,0,3,2129,962,0,0
10/23/2020,733,0,0,9,2215,300,0,0
08/28/2020,500,0,0,11,2135,419,0,0
10/30/2020,553,0,0,9,2119,960,0,0
09/26/2020,552,0,0,9,2119,900,0,0
12/17/2020,553,0,0,7,2122,900,0,0
11/25/2020,745,0,0,6,2127,429,0,0
12/22/2020,553,0,0,7,2121,400,0,0
08-11-2020,142,0,0,1,2128,952,0,0
11/17/2020,744,0,0,7,2122,429,0,0
07/19/2020,553,0,0,8,2124,429,0,0
08/24/2020,746,0,0,8,2124,429,0,0
09-10-2020,714,0,0,4,2111,400,0,0
07/31/2020,553,0,0,6,2125,429,0,0
12/24/2020,714,0,0,7,2121,429,0,0
07/18/2020,743,0,0,9,2119,400,0,0
12-05-2020,510,0,0,1,2128,900,0,0
09/23/2020,142,0,0,8,2124,429,0,0
11-07-2020,714,0,0,7,2125,429,0,0
12-09-2020,553,0,0,9,2119,960,0,0
10/22/2020,553,0,0,8,2124,429,0,0
08/27/2020,554,0,0,1,2128,429,0,0
09/14/2020,550,0,0,9,2121,960,0,0
07/20/2020,113,0,0,11,2134,429,0,0
08-09-2020,142,0,0,1,2128,951,0,0
09/21/2020,442,0,0,8,2124,429,0,0
11-09-2020,422,0,0,4,2215,963,0,0
07-06-2020,743,0,0,6,2127,429,0,0
11/25/2020,553,0,0,6,2118,900,0,0
11/16/2020,600,0,0,12,2131,960,0,0
08/17/2020,745,0,0,9,2120,429,0,0
09/19/2020,554,0,0,3,2113,429,0,0
12/19/2020,714,0,0,12,2132,161,0,0
09/29/2020,714,0,0,4,2118,419,0,0
12-09-2020,531,0,0,3,2114,400,0,0
08-03-2020,735,0,0,4,2111,599,0,0
09/30/2020,553,0,0,4,2118,900,0,0
09/28/2020,743,0,0,7,2125,429,0,0
11-12-2020,600,0,0,6,2125,900,0,0
08-04-2020,553,0,0,4,2118,960,0,0
09/28/2020,714,0,0,6,2210,400,0,0
08/15/2020,553,0,0,9,2119,400,0,0
10-09-2020,553,0,0,3,2114,960,0,0
07-09-2020,745,0,0,7,2121,429,0,0
12/26/2020,553,0,0,3,2114,460,0,0
12/14/2020,553,0,0,6,2125,500,0,0
10/15/2020,743,0,0,4,2115,400,0,0
08-04-2020,553,0,0,7,2125,962,0,0
07/18/2020,511,0,0,7,2121,429,0,0
12-05-2020,700,0,0,4,2116,174,0,0
07/20/2020,714,0,0,4,2120,400,0,0
08/29/2020,711,0,0,7,2122,962,0,0
08-12-2020,715,0,0,7,2125,500,0,0
08/21/2020,743,0,0,12,2132,429,0,0
08-04-2020,714,0,0,11,2134,160,0,0
08/15/2020,743,0,0,12,2130,429,0,0
12/30/2020,113,0,0,9,2119,419,0,0
11-04-2020,553,0,0,6,2118,460,0,0
10/28/2020,553,0,0,3,2110,900,0,0
11/23/2020,743,0,0,7,2122,400,0,0
10/29/2020,733,0,0,3,2113,161,0,0
12/28/2020,745,0,0,3,2114,500,0,0
12/20/2020,553,0,0,7,2118,100,0,0
09-07-2020,553,0,0,7,2119,400,0,0
12-06-2020,733,0,0,3,2111,599,0,0
07/31/2020,733,0,0,11,2135,419,0,0
09/24/2020,743,0,0,4,2215,429,0,0
10/31/2020,552,0,0,1,2128,429,0,0
11-03-2020,735,0,0,11,2135,592,0,0
07-07-2020,714,0,0,7,2121,459,0,0
07-11-2020,715,0,0,4,2118,429,0,0
08-12-2020,424,0,0,1,2128,700,0,0
11/30/2020,700,0,0,7,2118,100,0,0
07/19/2020,500,0,0,11,2135,962,0,0
09/23/2020,745,0,0,7,2121,429,0,0
10/18/2020,743,0,0,3,2129,419,0,0
07-06-2020,511,0,0,6,2125,965,0,0
07-12-2020,700,0,0,9,2215,400,0,0
11/19/2020,741,0,0,4,2116,599,0,0
10/23/2020,511,0,0,7,2122,419,0,0
08-11-2020,735,0,0,6,2210,100,0,0
09-01-2020,653,0,0,7,2125,429,0,0
07/28/2020,553,0,0,6,2118,429,0,0
07/26/2020,151,0,0,6,2210,960,0,0
08-04-2020,444,0,0,4,2120,960,0,0
07-04-2020,553,0,0,9,2130,400,0,0
07-09-2020,743,0,0,3,2129,952,0,0
09/16/2020,733,0,0,4,2118,400,0,0
12/27/2020,711,0,0,12,2132,960,0,0
08/17/2020,735,0,0,3,2110,599,0,0
10/22/2020,900,0,0,1,2128,900,0,0
11-11-2020,511,0,0,7,2122,429,0,0
07-01-2020,553,0,0,3,2109,500,0,0
11-10-2020,744,0,0,3,2129,519,0,0
11/26/2020,745,0,0,6,2127,429,0,0
10/25/2020,511,0,0,7,2121,965,0,0
11-09-2020,113,0,0,6,2127,429,0,0
11/13/2020,745,0,0,4,2111,592,0,0
10/14/2020,553,0,0,1,2128,419,0,0
11/16/2020,222,0,0,7,2125,429,0,0
08/24/2020,745,0,0,11,2135,429,0,0
12/30/2020,600,0,0,4,2116,429,0,0
09-03-2020,700,0,0,11,2215,511,0,0
12-10-2020,553,0,0,7,2119,419,0,0
07/27/2020,745,0,0,4,2116,429,0,0
09/19/2020,745,0,0,8,2126,429,0,0
12/16/2020,900,0,0,6,2127,210,0,0
08/25/2020,113,0,0,4,2116,419,0,0
07-11-2020,745,0,0,4,2116,400,0,0
08/13/2020,522,0,0,6,2125,429,0,0
08/16/2020,743,0,0,7,2122,519,0,0
12/22/2020,445,0,0,6,2127,429,0,0
11/17/2020,733,0,0,4,2215,400,0,0
07/31/2020,553,0,0,3,2114,960,0,0
11/19/2020,743,0,0,6,2127,500,0,0
07/31/2020,553,0,0,4,2118,960,0,0
08/31/2020,113,0,0,4,2118,400,0,0
12/23/2020,735,0,0,4,2116,449,0,0
12-05-2020,745,0,0,6,2127,400,0,0
09-04-2020,522,0,0,9,2115,429,0,0
11-08-2020,553,0,0,6,2210,960,0,0
07/30/2020,600,0,0,12,2131,419,0,0
10/13/2020,500,0,0,8,2122,419,0,0
08-04-2020,745,0,0,4,2111,174,0,0
12-10-2020,743,0,0,4,2111,429,0,0
11/27/2020,400,0,0,11,2135,419,0,0
11/25/2020,552,0,0,1,2128,960,0,0
11-06-2020,745,0,0,9,2115,400,0,0
09-03-2020,600,0,0,11,2135,429,0,0
09-02-2020,600,0,0,6,2125,960,0,0
09-02-2020,553,0,0,4,2118,960,0,0
09/15/2020,113,0,0,9,2130,400,0,0
07/21/2020,553,0,0,3,2129,400,0,0
08/13/2020,400,0,0,9,2119,962,0,0
12-09-2020,553,0,0,3,2129,962,0,0
09/19/2020,553,0,0,12,2132,900,0,0
12/17/2020,714,0,0,9,2132,400,0,0
08/21/2020,715,0,0,11,2135,429,0,0
12/24/2020,743,0,0,4,2116,429,0,0
11/26/2020,554,0,0,9,2120,419,0,0
10-04-2020,553,0,0,4,2118,960,0,0
11-12-2020,553,0,0,3,2129,419,0,0
07/23/2020,553,0,0,4,2115,400,0,0
07-05-2020,413,0,0,1,2109,922,0,0
08/20/2020,522,0,0,3,2110,599,0,0
12-01-2020,522,0,0,8,2124,100,0,0
11-02-2020,445,0,0,8,2124,962,0,0
09-09-2020,745,0,0,4,2215,400,0,0
09-12-2020,553,0,0,7,2118,429,0,0
07/29/2020,553,0,0,1,2128,419,0,0
11/27/2020,700,0,0,3,2113,549,0,0
07/24/2020,712,0,0,3,2129,152,0,0
07/22/2020,600,0,0,4,2116,429,0,0
07/17/2020,712,0,0,8,2124,429,0,0
09-10-2020,712,0,0,4,2118,439,0,0
07/30/2020,714,0,0,1,2128,400,0,0
11-11-2020,745,0,0,12,2132,500,0,0
08/31/2020,413,0,0,6,2110,963,0,0
12/25/2020,651,0,0,7,2121,429,0,0
09-07-2020,600,0,0,6,2210,960,0,0
09-10-2020,743,0,0,7,2122,429,0,0
12/24/2020,745,0,0,7,2125,429,0,0
10-11-2020,600,0,0,4,2116,900,0,0
12-04-2020,743,0,0,4,2111,592,0,0
08/28/2020,714,0,0,4,2116,429,0,0
09/26/2020,743,0,0,4,2118,429,0,0
10-02-2020,550,0,0,4,2116,963,0,0
08-12-2020,744,0,0,4,2215,500,0,0
11/19/2020,735,0,0,12,2132,161,0,0
11/13/2020,740,0,0,3,2129,962,0,0
10/25/2020,735,0,0,7,2125,459,0,0
11/18/2020,552,0,0,7,2125,900,0,0
09/28/2020,733,0,0,11,2134,429,0,0
10-01-2020,743,0,0,6,2127,429,0,0
08/19/2020,553,0,0,4,2115,241,0,0
07/14/2020,745,0,0,1,2128,215,0,0
09/25/2020,553,0,0,4,2116,900,0,0
09/25/2020,743,0,0,12,2132,215,0,0
09-09-2020,113,0,0,12,2132,419,0,0
10-07-2020,736,0,0,8,2124,429,0,0
10/15/2020,553,0,0,6,2122,961,0,0
07/20/2020,553,0,0,4,2118,300,0,0
10-12-2020,600,0,0,4,2118,900,0,0
09-07-2020,735,0,0,11,2134,429,0,0
12/13/2020,553,0,0,7,2121,962,0,0
08/29/2020,743,0,0,11,2135,429,0,0
10-08-2020,553,0,0,1,2128,962,0,0
10/21/2020,715,0,0,7,2125,429,0,0
09/23/2020,600,0,0,7,2125,900,0,0
11/14/2020,715,0,0,11,2163,460,0,0
09-09-2020,113,0,0,11,2135,439,0,0
10/31/2020,553,0,0,9,2115,900,0,0
10/15/2020,553,0,0,8,2122,500,0,0
09/19/2020,745,0,0,7,2125,419,0,0
10-07-2020,553,0,0,12,2136,900,0,0
07/16/2020,553,0,0,3,2108,931,0,0
09-11-2020,745,0,0,4,2116,400,0,0
12/26/2020,553,0,0,8,2124,429,0,0
08-04-2020,553,0,0,6,2127,900,0,0
11/26/2020,113,0,0,12,2136,419,0,0
07/20/2020,553,0,0,6,2118,960,0,0
08/19/2020,733,0,0,9,2120,429,0,0
08-12-2020,554,0,0,1,2128,429,0,0
08/24/2020,715,0,0,11,2134,429,0,0
10/31/2020,553,0,0,11,2135,962,0,0
10-08-2020,714,0,0,9,2119,429,0,0
09/27/2020,553,0,0,9,2130,311,0,0
09-11-2020,745,0,0,3,2114,981,0,0
09-07-2020,651,0,0,8,2126,300,0,0
12-09-2020,714,0,0,7,2121,500,0,0
09-12-2020,741,0,0,1,2128,400,0,0
10/24/2020,735,0,0,6,2127,429,0,0
09/24/2020,154,0,0,12,2132,962,0,0
07-09-2020,735,0,0,3,2111,500,0,0
09/17/2020,651,0,0,11,2135,429,0,0
12/21/2020,711,0,0,3,2129,922,0,0
09/22/2020,600,0,0,12,2136,960,0,0
08/24/2020,715,0,0,6,2127,400,0,0
07-02-2020,743,0,0,3,2114,400,0,0
09/13/2020,600,0,0,8,2124,419,0,0
09/24/2020,510,0,0,7,2122,459,0,0
07/20/2020,553,0,0,9,2119,419,0,0
09/30/2020,745,0,0,6,2127,429,0,0
11/24/2020,714,0,0,4,2115,500,0,0
11/24/2020,731,0,0,3,2129,500,0,0
08-04-2020,715,0,0,8,2126,419,0,0
08/28/2020,553,0,0,6,2127,900,0,0
09-01-2020,733,0,0,8,2126,400,0,0
07/28/2020,554,0,0,9,2121,429,0,0
08-04-2020,140,0,0,1,2128,900,0,0
08-02-2020,735,0,0,7,2119,429,0,0
10/21/2020,553,0,0,12,2126,960,0,0
08/29/2020,745,0,0,7,2125,419,0,0
09/21/2020,714,0,0,4,2118,331,0,0
10/26/2020,745,0,0,6,2210,599,0,0
08/29/2020,553,0,0,9,2121,429,0,0
07/13/2020,700,0,0,7,2119,460,0,0
09/30/2020,531,0,0,7,2125,429,0,0
10-02-2020,552,0,0,8,2126,419,0,0
08/25/2020,600,0,0,8,2122,900,0,0
12-09-2020,413,0,0,12,2131,419,0,0
09-04-2020,113,0,0,11,2134,419,0,0
08-03-2020,735,0,0,12,2132,161,0,0
10-12-2020,553,0,0,1,2128,449,0,0
10-09-2020,651,0,0,12,2136,100,0,0
10/27/2020,553,0,0,3,2114,900,0,0
07-09-2020,553,0,0,9,2119,429,0,0
08/22/2020,745,0,0,9,2132,557,0,0
08/18/2020,735,0,0,7,2124,429,0,0
11/28/2020,553,0,0,9,2119,400,0,0
11-07-2020,553,0,0,3,2114,900,0,0
09/23/2020,735,0,0,12,2132,429,0,0
12/18/2020,554,0,0,11,2135,419,0,0
08/22/2020,442,0,0,9,2119,429,0,0
11/27/2020,113,0,100,4,2120,400,100,0
12-01-2020,743,0,0,11,2135,429,0,0
10/23/2020,500,0,0,11,2135,419,0,0
08/24/2020,553,0,0,12,2132,429,0,0
11/22/2020,142,0,0,12,2132,900,0,0
10/13/2020,745,0,0,3,2129,519,0,0
12-05-2020,522,0,0,4,2115,429,0,0
08/29/2020,600,0,0,4,2118,962,0,0
09-12-2020,113,0,0,12,2136,429,0,0
09-06-2020,553,0,0,8,2122,900,0,0
11/13/2020,113,0,0,4,2118,400,0,0
07-08-2020,551,0,0,9,2121,429,0,0
07-03-2020,745,0,0,9,2121,429,0,0
07/28/2020,600,0,0,4,2118,900,0,0
10-01-2020,150,0,0,8,2126,938,0,0
09/30/2020,600,0,0,4,2111,963,0,0
11/25/2020,550,0,0,4,2118,429,0,0
10-11-2020,743,0,0,1,2128,419,0,0
09/22/2020,735,0,0,3,2129,419,0,0
12/25/2020,745,0,0,11,2215,460,0,0
09-11-2020,553,0,0,12,2132,900,0,0
12-08-2020,553,0,0,4,2118,962,0,0
10/21/2020,553,0,0,9,2467,500,0,0
07-04-2020,714,0,0,7,2121,400,0,0
07-08-2020,735,0,0,9,2130,400,0,0
10-04-2020,553,0,0,6,2210,449,0,0
11-02-2020,743,0,0,8,2124,429,0,0
08/23/2020,735,0,0,9,2120,429,0,0
12-01-2020,743,0,0,4,2111,500,0,0
11/26/2020,113,0,0,3,2129,400,0,0
12/17/2020,553,0,0,4,2116,962,0,0
12-09-2020,553,0,0,4,2116,900,0,0
10-11-2020,150,0,0,12,2130,938,0,0
08/21/2020,714,0,0,9,2115,300,0,0
11-04-2020,743,0,0,6,2125,429,0,0
11/20/2020,744,0,0,11,2134,429,0,0
11/14/2020,553,0,0,6,2127,429,0,0
10-08-2020,733,0,0,11,2135,400,0,0
10/23/2020,552,0,0,4,2115,900,0,0
07/28/2020,740,0,0,8,2126,419,0,0
07-09-2020,745,0,0,4,2118,599,0,0
09-02-2020,735,0,0,11,2134,500,0,0
09/18/2020,745,0,0,3,2114,400,0,0
10/16/2020,714,0,0,11,2134,400,0,0
10/27/2020,714,0,0,4,2116,419,0,0
11/14/2020,743,0,0,9,2115,429,0,0
11/25/2020,714,0,0,8,2126,400,0,0
12/13/2020,714,0,0,9,2121,429,0,0
09-01-2020,652,0,0,9,2119,500,0,0
07-03-2020,553,0,0,9,2115,936,0,0
10-06-2020,745,0,0,3,2111,449,0,0
09/24/2020,500,0,0,4,2116,963,0,0
11/18/2020,554,0,0,8,2126,419,0,0
10/13/2020,553,0,0,8,2126,963,0,0
07-06-2020,552,0,0,12,2131,888,0,0
12-09-2020,554,0,0,12,2136,419,0,0
10/23/2020,553,0,0,3,2111,965,0,0
08/15/2020,553,0,0,8,2124,960,0,0
08-04-2020,553,0,0,12,2132,419,0,0
08/31/2020,522,0,0,8,2122,579,0,0
08-09-2020,733,0,0,1,2128,429,0,0
11-09-2020,154,0,0,8,2124,965,0,0
08/29/2020,113,0,20,8,2124,419,20,0
08/23/2020,736,0,0,9,2120,429,0,0
08/18/2020,740,0,0,4,2116,599,0,0
11/28/2020,412,0,0,3,2114,400,0,0
08-03-2020,445,0,0,9,2115,900,0,0
07/24/2020,712,0,0,4,2116,429,0,0
11/20/2020,741,0,0,3,2110,449,0,0
12-07-2020,714,0,0,7,2122,700,0,0
07/19/2020,522,0,0,4,2118,439,0,0
10-09-2020,552,0,0,8,2126,419,0,0
10-02-2020,735,0,0,9,2120,429,0,0
08-03-2020,714,0,0,9,2130,429,0,0
07-01-2020,113,0,0,9,2120,429,0,0
10/17/2020,714,0,0,3,2114,429,0,0
12/19/2020,745,0,0,3,2108,429,0,0
09-09-2020,440,0,0,11,2135,962,0,0
11-01-2020,113,0,0,4,2118,429,0,0
08-05-2020,600,0,0,4,2118,963,0,0
11-12-2020,413,0,0,8,2126,963,0,0
07/13/2020,511,0,0,9,2119,400,0,0
07/23/2020,743,0,0,12,2132,519,0,0
08/21/2020,142,0,0,12,2136,900,0,0
10-02-2020,551,0,0,12,2136,962,0,0
09-12-2020,554,0,0,8,2124,400,0,0
09/22/2020,552,0,0,8,2124,962,0,0
07-05-2020,740,0,0,12,2132,311,0,0
11/26/2020,735,0,0,4,2111,519,0,0
12-12-2020,113,0,0,6,2127,429,0,0
09/30/2020,745,0,0,3,2129,882,0,0
09/13/2020,554,0,0,3,2129,429,0,0
10-06-2020,745,0,0,3,2129,429,0,0
12/18/2020,113,0,0,3,2114,400,0,0
12/21/2020,552,0,0,3,2111,429,0,0
09-01-2020,743,0,0,7,2119,500,0,0
12/28/2020,733,0,0,12,2132,419,0,0
10/19/2020,735,0,0,11,2134,400,0,0
11/25/2020,745,0,0,4,2118,429,0,0
07-08-2020,553,0,0,7,2121,963,0,0
12-07-2020,735,0,0,4,2118,429,0,0
07-06-2020,554,0,0,8,2126,429,0,0
09-07-2020,553,0,0,6,2127,900,0,0
07/19/2020,424,0,0,1,2128,429,0,0
09/27/2020,745,0,0,3,2113,419,0,0
07/31/2020,743,0,0,4,2111,173,0,0
09/25/2020,554,0,0,7,2124,419,0,0
12/30/2020,745,0,0,8,2124,429,0,0
08-01-2020,553,0,0,6,2127,429,0,0
11-06-2020,553,0,0,3,2114,900,0,0
12/17/2020,113,0,0,11,2135,429,0,0
08/28/2020,551,0,0,7,2125,419,0,0
08/16/2020,553,0,0,9,2119,960,0,0
10/31/2020,440,0,0,7,2125,962,0,0
07/31/2020,551,0,0,7,2118,429,0,0
09-04-2020,600,0,0,7,2119,419,0,0
10-08-2020,745,0,0,7,2125,429,0,0
09/29/2020,735,0,0,6,2127,429,0,0
10-11-2020,424,0,0,12,2132,419,0,0
10/21/2020,745,0,0,3,2114,174,0,0
09-03-2020,553,0,0,4,2116,960,0,0
09-06-2020,554,0,0,12,2136,419,0,0
10/24/2020,600,0,0,4,2111,429,0,0
12/31/2020,714,0,0,7,2121,429,0,0
10/20/2020,554,0,0,7,2125,429,0,0
07-02-2020,743,0,0,4,2215,429,0,0
10/20/2020,553,0,0,6,2127,960,0,0
12-11-2020,714,0,0,12,2131,161,0,0
08-11-2020,553,0,0,1,2128,962,0,0
11/25/2020,735,0,0,3,2108,400,0,0
08/13/2020,714,0,0,9,2121,429,0,0
07-05-2020,522,0,0,12,2132,960,0,0
07/27/2020,715,0,0,4,2115,429,0,0
10-05-2020,522,0,0,9,2130,429,0,0
10/17/2020,553,0,0,11,2135,960,0,0
11/25/2020,511,0,0,11,2135,965,0,0
10-11-2020,113,0,0,6,2127,429,0,0
10/14/2020,500,0,0,4,2118,400,0,0
11/30/2020,743,0,0,7,2125,429,0,0
10-07-2020,553,0,0,6,2127,962,0,0
08/15/2020,741,0,0,8,2124,363,0,0
10/30/2020,554,0,0,12,2131,400,0,0
11/28/2020,743,0,0,4,2111,519,0,0
11/13/2020,553,0,0,9,2130,331,0,0
09/20/2020,553,0,0,8,2124,429,0,0
12-08-2020,600,0,0,12,2132,962,0,0
10/25/2020,553,0,0,4,2118,900,0,0
11/19/2020,731,0,0,3,2129,965,0,0
08/27/2020,113,0,0,4,2118,400,0,0
07/19/2020,746,0,0,8,2124,429,0,0
09/22/2020,212,0,0,4,2215,400,0,0
08/27/2020,744,0,0,4,2118,459,0,0
08-12-2020,400,0,0,9,2130,549,0,0
10/14/2020,746,0,0,1,2128,429,0,0
12-05-2020,444,0,0,9,2131,962,0,0
07/26/2020,600,0,0,4,2116,500,0,0
11/25/2020,622,0,0,6,2127,960,0,0
07-11-2020,553,0,0,4,2115,900,0,0
12-04-2020,522,0,0,4,2116,400,0,0
12/24/2020,651,0,0,3,2129,400,0,0
09-12-2020,631,0,0,6,2127,419,0,0
11-05-2020,736,0,0,11,2134,429,0,0
07-02-2020,451,0,0,4,2116,500,0,0
08/22/2020,554,0,0,4,2118,962,0,0
10/25/2020,553,0,0,6,2127,400,0,0
07/29/2020,714,0,0,1,2128,400,0,0
10-09-2020,553,0,0,11,2134,962,0,0
08-05-2020,553,0,0,3,2113,429,0,0
10/24/2020,715,0,0,8,2124,429,0,0
10/23/2020,714,0,0,4,2116,500,0,0
10-10-2020,522,0,0,7,2119,960,0,0
08/18/2020,600,0,0,8,2126,900,0,0
11/25/2020,500,0,0,7,2125,400,0,0
08/19/2020,746,0,0,7,2125,429,0,0
09/23/2020,600,0,0,8,2124,900,0,0
09/13/2020,154,0,0,6,2127,936,0,0
08-08-2020,735,0,0,8,2124,131,0,0
07/30/2020,700,0,0,7,2119,400,0,0
07-04-2020,553,0,0,7,2119,900,0,0
07-04-2020,400,0,0,7,2125,419,0,0
10/30/2020,740,0,0,3,2114,960,0,0
12/27/2020,700,0,0,6,2127,140,0,0
11-07-2020,554,0,0,7,2122,429,0,0
09/28/2020,600,0,0,1,2128,900,0,0
07/27/2020,511,0,0,8,2124,400,0,0
07/24/2020,151,0,0,9,2119,900,0,0
08-10-2020,522,0,0,8,2124,429,0,0
10-01-2020,743,0,0,12,2136,419,0,0
09/21/2020,553,0,0,3,2113,519,0,0
07/16/2020,714,0,0,4,2116,429,0,0
12/20/2020,736,0,0,12,2136,400,0,0
07-05-2020,113,0,0,9,2115,429,0,0
07-12-2020,553,0,0,6,2118,100,0,0
07-12-2020,743,0,0,7,2125,429,0,0
07-05-2020,735,0,0,4,2116,500,0,0
09-09-2020,714,0,0,4,2116,500,0,0
08-02-2020,553,0,0,11,2135,960,0,0
10-05-2020,554,0,0,4,2116,429,0,0
12-08-2020,735,0,0,4,2215,241,0,0
10-02-2020,552,0,0,7,2125,900,0,0
09/26/2020,600,0,0,6,2210,960,0,0
08-11-2020,553,0,0,8,2124,419,0,0
12/26/2020,736,0,0,9,2119,419,0,0
07-06-2020,553,0,0,7,2122,429,0,0
11-06-2020,744,0,0,4,2116,429,0,0
08-11-2020,745,0,0,4,2116,599,0,0
10-07-2020,440,0,0,9,2130,400,0,0
09/28/2020,424,0,0,8,2124,429,0,0
07/15/2020,743,0,0,4,2115,429,0,0
10/22/2020,553,0,0,9,2115,900,0,0
07-07-2020,500,0,0,12,2126,938,0,0
08-04-2020,735,0,0,9,2120,400,0,0
10/20/2020,550,0,0,7,2125,429,0,0
08/13/2020,600,0,0,9,2121,429,0,0
10/31/2020,113,0,0,7,2125,429,0,0
12-10-2020,553,0,0,8,2124,429,0,0
08-06-2020,500,0,0,6,2210,500,0,0
12/13/2020,522,0,0,4,2116,429,0,0
11/22/2020,553,0,0,12,2467,900,0,0
10-03-2020,652,0,0,9,2115,429,0,0
12/17/2020,500,0,0,7,2122,429,0,0
09/21/2020,714,0,0,8,2124,429,0,0
10/22/2020,500,0,0,12,2132,900,0,0
12-12-2020,714,0,0,6,2210,439,0,0
09-03-2020,113,0,0,9,2115,429,0,0
08/28/2020,500,0,0,12,2132,419,0,0
12/25/2020,715,0,0,7,2125,429,0,0
07-05-2020,553,0,0,7,2118,900,0,0
07-11-2020,651,0,0,11,2135,429,0,0
12/17/2020,113,0,0,9,2115,439,0,0
08/21/2020,553,0,0,9,2119,900,0,0
09/23/2020,743,0,0,1,2128,429,0,0
10/28/2020,553,0,0,7,2121,429,0,0
12-01-2020,735,0,0,7,2125,160,0,0
09-12-2020,500,0,0,6,2125,400,0,0
09/26/2020,714,0,0,4,2118,439,0,0
08/28/2020,553,0,0,3,2114,400,0,0
09/22/2020,553,0,0,6,2119,900,0,0
10/14/2020,745,0,0,9,2120,429,0,0
08-06-2020,735,0,0,3,2129,429,0,0
08/20/2020,553,0,0,8,2124,900,0,0
12/21/2020,424,0,0,7,2119,429,0,0
07/14/2020,511,0,0,3,2129,400,0,0
12/16/2020,600,0,0,4,2118,900,0,0
08-04-2020,554,0,0,8,2126,419,0,0
12-06-2020,733,0,0,6,2125,152,0,0
08-10-2020,445,0,0,8,2122,900,0,0
11-04-2020,451,0,0,9,2130,365,0,0
10-01-2020,711,0,0,3,2113,963,0,0
07-12-2020,445,0,0,3,2113,161,0,0
09/30/2020,553,0,0,7,2125,962,0,0
11/25/2020,736,0,0,11,2134,429,0,0
12-04-2020,553,0,0,8,2124,962,0,0
10/13/2020,554,0,0,6,2127,429,0,0
08/31/2020,553,0,0,9,2215,429,0,0
08/16/2020,444,0,0,11,2135,962,0,0
09-01-2020,113,0,0,8,2126,400,0,0
07-03-2020,713,0,0,9,2215,965,0,0
11/27/2020,113,0,0,7,2125,419,0,0
09/19/2020,745,0,0,11,2163,882,0,0
08-03-2020,171,0,0,7,2121,900,0,0
09-08-2020,553,0,0,4,2118,960,0,0
10/15/2020,745,0,0,4,2116,429,0,0
08-03-2020,552,0,0,1,2128,400,0,0
09/19/2020,653,0,0,6,2127,429,0,0
12/26/2020,743,0,0,7,2122,519,0,0
09-10-2020,730,0,0,12,2132,459,0,0
09-04-2020,735,0,0,7,2125,419,0,0
09-02-2020,554,0,0,12,2132,429,0,0
12/31/2020,711,0,0,6,2127,960,0,0
10/15/2020,745,0,0,4,2215,429,0,0
10/30/2020,553,0,0,9,2120,960,0,0
12/24/2020,113,0,0,12,2136,429,0,0
12/18/2020,113,0,0,9,2121,419,0,0
10-09-2020,733,0,0,1,2128,400,0,0
12/22/2020,745,0,0,6,2210,599,0,0
07/27/2020,412,0,0,7,2122,900,0,0
07/22/2020,160,0,0,6,2127,900,0,0
12/31/2020,712,0,0,4,2116,429,0,0
12/16/2020,611,0,0,12,2131,429,0,0
08/17/2020,714,0,0,4,2215,400,0,0
07/25/2020,441,0,0,12,2131,569,0,0
09/23/2020,622,0,0,7,2122,170,0,0
11/15/2020,553,0,0,4,2118,963,0,0
11/30/2020,735,0,0,1,2128,400,0,0
08-01-2020,553,0,0,9,2119,592,0,0
10-07-2020,553,0,0,9,2132,960,0,0
12/14/2020,500,0,0,7,2124,900,0,0
08-12-2020,113,0,0,1,2128,439,0,0
07-01-2020,735,0,0,3,2108,599,0,0
08/31/2020,743,0,0,4,2199,400,0,0
10/18/2020,736,0,0,12,2131,419,0,0
07/22/2020,735,0,0,8,2126,429,0,0
07/29/2020,735,0,0,6,2210,449,0,0
09/19/2020,412,0,0,9,2130,400,0,0
07-11-2020,743,0,0,12,2131,500,0,0
11-09-2020,554,0,0,8,2124,300,0,0
08/24/2020,412,0,0,11,2134,429,0,0
11/23/2020,600,0,0,4,2116,961,0,0
07/21/2020,734,0,0,11,2135,429,0,0
08/21/2020,552,0,0,4,2115,519,0,0
12/17/2020,735,0,0,12,2132,593,0,0
08-07-2020,731,0,0,9,2120,439,0,0
08-01-2020,700,0,0,9,2130,592,0,0
08/28/2020,553,0,0,12,2467,900,0,0
12/23/2020,511,0,0,6,2125,960,0,0
12/27/2020,641,0,0,12,2132,888,0,0
09/14/2020,510,0,0,11,2135,900,0,0
11/15/2020,715,0,0,11,2135,400,0,0
07/18/2020,113,0,0,7,2122,429,0,0
09/30/2020,424,0,0,6,2127,429,0,0
07/17/2020,554,0,0,12,2126,419,0,0
08-01-2020,743,0,0,8,2126,429,0,0
09/14/2020,743,0,0,8,2126,429,0,0
10-04-2020,736,0,0,3,2109,429,0,0
12-08-2020,900,0,0,6,2111,429,0,0
10/14/2020,511,0,0,3,2114,960,0,0
07/22/2020,735,0,0,6,2127,891,0,0
10-09-2020,714,0,0,4,2115,419,0,0
09/15/2020,733,0,0,11,2135,429,0,0
07-08-2020,743,0,0,3,2129,429,0,0
10/25/2020,553,0,0,4,2118,400,0,0
11-10-2020,711,0,0,12,2131,963,0,0
07/19/2020,743,0,0,12,2131,419,0,0
12-04-2020,745,0,0,1,2128,429,0,0
08-07-2020,745,0,0,7,2121,429,0,0
09-02-2020,714,0,0,4,2115,429,0,0
08-09-2020,553,0,0,6,2127,429,0,0
09/14/2020,712,0,0,11,2135,331,0,0
07/27/2020,715,0,0,7,2122,429,0,0
12-10-2020,554,0,0,3,2114,429,0,0
09-08-2020,150,0,0,7,2122,429,0,0
09-09-2020,554,0,0,8,2124,419,0,0
08-09-2020,553,0,0,6,2125,900,0,0
10-07-2020,813,0,0,1,2128,938,0,0
08/24/2020,553,0,0,12,2131,429,0,0
11-04-2020,511,0,0,7,2125,429,0,0
11-12-2020,500,0,0,8,2126,429,0,0
07-07-2020,522,0,0,6,2127,400,0,0
09/22/2020,745,0,0,6,2127,419,0,0
10-05-2020,552,0,0,3,2114,962,0,0
08/14/2020,554,0,0,11,2135,400,0,0
07-09-2020,412,0,0,6,2127,962,0,0
08/13/2020,715,0,0,11,2135,419,0,0
11/26/2020,553,0,0,9,2130,900,0,0
09/26/2020,600,0,0,4,2115,429,0,0
07/25/2020,151,0,0,6,2127,900,0,0
10/13/2020,714,0,0,8,2124,429,0,0
10/30/2020,553,0,0,9,2130,400,0,0
09-04-2020,411,0,0,9,2119,963,0,0
10/30/2020,600,0,0,3,2114,960,0,0
10/24/2020,553,0,0,7,2121,900,0,0
12-03-2020,611,0,0,4,2118,429,0,0
12-02-2020,553,0,0,1,2128,439,0,0
10/14/2020,600,0,0,3,2114,900,0,0
08/19/2020,743,0,0,4,2115,400,0,0
12/22/2020,745,0,0,8,2124,419,0,0
08/30/2020,700,0,0,4,2215,500,0,0
07/24/2020,740,0,0,11,2215,460,0,0
12/16/2020,744,0,0,1,2128,519,0,0
10/19/2020,900,0,0,3,2109,429,0,0
07/24/2020,714,0,0,7,2125,400,0,0
10-06-2020,553,0,0,9,2130,900,0,0
11/22/2020,745,0,0,11,2467,500,0,0
08/16/2020,553,0,0,6,2125,429,0,0
10/30/2020,745,0,0,4,2116,500,0,0
11/14/2020,600,0,0,4,2215,429,0,0
09-03-2020,511,0,0,9,2119,962,0,0
08/29/2020,745,0,0,11,2135,200,0,0
12/17/2020,118,0,0,6,2127,419,0,0
10/25/2020,151,0,0,1,2128,962,0,0
07/16/2020,745,0,0,3,2108,500,0,0
10/31/2020,553,0,0,4,2115,900,0,0
09/26/2020,600,0,0,8,2122,963,0,0
07-07-2020,400,0,0,7,2122,429,0,0
07/13/2020,553,0,0,7,2119,900,0,0
10-04-2020,651,0,0,6,2127,429,0,0
09-11-2020,600,0,0,3,2129,963,0,0
07-10-2020,522,0,0,4,2115,449,0,0
10/22/2020,553,0,0,3,2113,400,0,0
11-03-2020,552,0,0,7,2125,429,0,0
10-08-2020,553,0,0,1,2128,900,0,0
09-03-2020,745,0,0,8,2124,170,0,0
11/20/2020,522,0,0,11,2467,400,0,0
08/21/2020,553,0,0,3,2109,900,0,0
12/30/2020,500,0,0,8,2126,400,0,0
10-08-2020,651,0,0,11,2134,400,0,0
09/29/2020,743,0,0,7,2125,900,0,0
08/16/2020,714,0,0,7,2121,429,0,0
08/20/2020,735,0,0,9,2120,400,0,0
09/26/2020,551,0,0,9,2121,963,0,0
08/14/2020,553,0,0,7,2122,962,0,0
07/19/2020,424,0,0,8,2126,419,0,0
09/29/2020,736,0,0,4,2118,400,0,0
09-04-2020,736,0,0,6,2127,429,0,0
09/23/2020,711,0,0,1,2128,960,0,0
09-11-2020,531,0,0,4,2115,400,0,0
09-06-2020,611,0,0,8,2124,429,0,0
07-07-2020,113,0,0,9,2130,400,0,0
08-03-2020,553,0,0,7,2119,960,0,0
10/29/2020,553,0,0,11,2135,429,0,0
08/16/2020,714,0,0,9,2130,331,0,0
08/23/2020,733,0,0,1,2128,429,0,0
11-07-2020,553,0,0,8,2124,900,0,0
07/28/2020,733,0,0,3,2113,429,0,0
12-01-2020,735,0,0,11,2135,500,0,0
07/16/2020,552,0,0,4,2118,100,0,0
10-04-2020,735,0,0,3,2109,500,0,0
09/27/2020,511,0,0,7,2125,100,0,0
12/19/2020,745,0,0,3,2108,429,0,0
09/27/2020,743,0,0,7,2125,429,0,0
07/24/2020,553,0,0,1,2128,429,0,0
12/15/2020,733,0,0,1,2128,429,0,0
11/20/2020,714,0,0,4,2118,429,0,0
12-06-2020,113,0,0,6,2125,460,0,0
09/25/2020,553,0,0,6,2127,960,0,0
07-02-2020,745,0,0,7,2121,131,0,0
07/31/2020,550,0,0,11,2134,938,0,0
09-03-2020,736,0,0,7,2124,419,0,0
07-05-2020,511,0,0,6,2127,429,0,0
07/27/2020,714,0,0,7,2125,519,0,0
07/22/2020,600,0,0,12,2136,419,0,0
10/26/2020,743,0,0,4,2118,331,0,0
08/16/2020,743,0,0,9,2130,419,0,0
10/16/2020,743,0,0,11,2134,500,0,0
11-07-2020,411,0,0,11,2135,962,0,0
08-11-2020,553,0,0,7,2125,900,0,0
09/18/2020,745,0,0,9,2130,429,0,0
10-11-2020,551,0,0,8,2124,429,0,0
09/24/2020,600,0,0,7,2125,429,0,0
07/14/2020,743,0,0,9,2115,429,0,0
07-05-2020,746,0,0,11,2135,400,0,0
07-08-2020,553,0,0,9,2119,900,0,0
10/18/2020,553,0,0,4,2116,400,0,0
10-06-2020,113,0,0,9,2119,400,0,0
10/21/2020,553,0,0,3,2129,962,0,0
08/19/2020,745,0,0,8,2126,429,0,0
12-07-2020,743,0,0,3,2108,400,0,0
08/19/2020,743,0,0,11,2134,429,0,0
11-08-2020,553,0,0,7,2125,962,0,0
08-04-2020,444,0,0,9,2130,962,0,0
10/26/2020,554,0,0,12,2132,419,0,0
11/13/2020,651,0,0,3,2114,460,0,0
10-08-2020,733,0,0,4,2118,429,0,0
09/26/2020,714,0,0,4,2115,400,0,0
08-07-2020,600,0,0,3,2108,900,0,0
10/26/2020,743,0,0,4,2115,400,0,0
08/21/2020,652,0,0,3,2108,500,0,0
10/24/2020,511,0,0,6,2127,400,0,0
12/29/2020,550,0,0,11,2135,921,0,0
12-08-2020,113,0,0,4,2215,429,0,0
11/27/2020,522,0,0,11,2135,400,0,0
07/18/2020,553,0,0,3,2109,900,0,0
08-08-2020,553,0,0,7,2125,960,0,0
11-09-2020,554,0,0,1,2128,419,0,0
10/14/2020,745,0,0,9,2119,429,0,0
07/25/2020,743,0,0,1,2128,429,0,0
07/21/2020,553,0,0,7,2125,519,0,0
10/23/2020,550,0,0,4,2118,439,0,0
07-09-2020,553,0,0,9,2130,900,0,0
07-04-2020,151,0,0,7,2122,429,0,0
07-02-2020,731,0,0,6,2210,161,0,0
09-12-2020,734,0,0,9,2121,400,0,0
12-02-2020,116,0,0,3,2129,419,0,0
09/30/2020,553,0,0,7,2124,400,0,0
08-02-2020,113,0,0,7,2125,429,0,0
11/20/2020,113,0,50,8,2126,429,50,0
09-09-2020,552,0,0,9,2119,429,0,0
12/29/2020,740,0,0,11,2134,549,0,0
10-12-2020,553,0,0,7,2119,900,0,0
10/30/2020,553,0,0,3,2129,960,0,0
09/15/2020,745,0,0,3,2129,880,0,0
08/29/2020,553,0,0,6,2127,900,0,0
08-07-2020,735,0,0,11,2135,460,0,0
10/20/2020,745,0,0,6,2210,429,0,0
07-05-2020,553,0,0,3,2108,900,0,0
11/23/2020,711,0,0,4,2118,960,0,0
10/29/2020,424,0,0,11,2135,400,0,0
10/16/2020,745,0,0,3,2108,500,0,0
09-04-2020,611,0,0,7,2124,960,0,0
09/14/2020,714,0,0,4,2116,419,0,0
07-02-2020,553,0,0,6,2118,100,0,0
09/30/2020,553,0,0,8,2124,419,0,0
07-06-2020,743,0,0,11,2135,322,0,0
08/18/2020,745,0,0,11,2135,519,0,0
09/30/2020,553,0,0,6,2127,962,0,0
07-12-2020,743,0,0,11,2135,429,0,0
08/13/2020,743,0,0,12,2132,331,0,0
09-11-2020,733,0,0,1,2128,429,0,0
10-05-2020,600,0,0,8,2136,419,0,0
09-02-2020,553,0,0,6,2118,963,0,0
10/14/2020,554,0,0,11,2135,419,0,0
12/26/2020,733,0,0,8,2124,419,0,0
09-09-2020,731,0,0,9,2120,429,0,0
11/21/2020,736,0,0,3,2129,400,0,0
08-10-2020,600,0,0,6,2125,900,0,0
09/21/2020,736,0,0,4,2115,460,0,0
09-06-2020,551,0,0,8,2122,571,0,0
11/30/2020,511,0,0,12,2131,960,0,0
07-09-2020,551,0,0,9,2119,960,0,0
12-06-2020,554,0,0,9,2130,429,0,0
09-02-2020,424,0,0,1,2128,429,0,0
11-07-2020,500,0,0,3,2114,900,0,0
08/19/2020,735,0,0,9,2130,400,0,0
12/16/2020,444,0,0,3,2129,900,0,0
12/22/2020,444,0,0,12,2136,960,0,0
08/30/2020,600,0,0,6,2210,800,0,0
08/24/2020,553,0,0,6,2125,961,0,0
08/29/2020,553,0,0,7,2121,400,0,0
11-12-2020,553,0,0,4,2116,900,0,0
10-03-2020,553,0,0,6,2127,900,0,0
08/30/2020,554,0,0,11,2135,429,0,0
08-05-2020,600,0,0,12,2132,961,0,0
07/31/2020,554,0,0,7,2122,962,0,0
10/28/2020,552,0,0,12,2136,960,0,0
11-11-2020,500,0,0,4,2118,400,0,0
09-04-2020,553,0,0,9,2130,962,0,0
08-09-2020,553,0,0,8,2126,900,0,0
08/23/2020,600,0,0,6,2127,960,0,0
08-12-2020,745,0,0,8,2124,429,0,0
11-11-2020,621,0,0,7,2119,400,0,0
10/13/2020,746,0,0,11,2134,429,0,0
12/20/2020,554,0,0,9,2119,400,0,0
10-02-2020,413,0,0,7,2121,961,0,0
09/30/2020,500,0,0,12,2136,419,0,0
10/20/2020,743,0,0,8,2126,419,0,0
07-07-2020,553,0,0,6,2118,960,0,0
12/14/2020,621,0,0,8,2126,419,0,0
08-07-2020,440,0,0,12,2132,888,0,0
08/28/2020,745,0,0,3,2129,419,0,0
08/21/2020,522,0,0,7,2119,400,0,0
07/26/2020,714,0,0,11,2134,429,0,0
12-10-2020,714,0,0,8,2126,419,0,0
09/25/2020,745,0,0,8,2124,400,0,0
09/15/2020,736,0,0,6,2127,160,0,0
12/25/2020,733,0,0,4,2199,500,0,0
09-01-2020,400,0,0,8,2124,429,0,0
08/26/2020,550,0,0,3,2109,882,0,0
09/15/2020,712,0,0,9,2130,960,0,0
11/16/2020,553,0,0,11,2215,429,0,0
07-11-2020,400,0,0,9,2119,429,0,0
12/28/2020,735,0,0,12,2131,429,0,0
10-07-2020,553,0,0,8,2124,960,0,0
10-07-2020,813,0,0,1,2128,880,0,0
10/31/2020,553,0,0,9,2119,429,0,0
08/28/2020,553,0,0,8,2124,900,0,0
11/20/2020,600,0,0,4,2118,960,0,0
12/20/2020,522,0,0,6,2127,429,0,0
08/14/2020,554,0,0,4,2115,400,0,0
07/23/2020,735,0,0,3,2108,400,0,0
11-10-2020,652,0,0,7,2121,131,0,0
10/18/2020,745,0,0,8,2124,429,0,0
11/29/2020,400,0,0,3,2113,419,0,0
11/21/2020,600,0,0,6,2125,900,0,0
09/23/2020,743,0,0,3,2109,599,0,0
09/27/2020,745,0,0,11,2134,322,0,0
08/21/2020,740,0,0,7,2119,700,0,0
07/23/2020,553,0,0,9,2119,900,0,0
10-04-2020,552,0,0,6,2127,130,0,0
07/22/2020,553,0,0,8,2126,419,0,0
10/24/2020,714,0,0,3,2129,419,0,0
10-03-2020,714,0,0,4,2115,429,0,0
09/13/2020,600,0,0,9,2130,400,0,0
10/21/2020,745,0,0,11,2135,429,0,0
12/23/2020,522,0,0,12,2131,429,0,0
07-02-2020,746,0,0,11,2134,429,0,0
07-01-2020,714,0,0,7,2121,429,0,0
12/26/2020,553,0,0,3,2114,400,0,0
10/23/2020,553,0,0,8,2124,900,0,0
11-10-2020,522,0,0,11,2135,213,0,0
07-03-2020,511,0,0,7,2119,960,0,0
09/30/2020,745,0,0,4,2116,500,0,0
08/31/2020,113,0,0,4,2115,429,0,0
11/28/2020,735,0,0,8,2126,254,0,0
07/28/2020,113,0,0,7,2125,429,0,0
09-11-2020,712,0,0,12,2136,151,0,0
08/30/2020,600,0,0,9,2119,965,0,0
12/24/2020,553,0,0,3,2129,419,0,0
09/25/2020,554,0,0,1,2128,429,0,0
10-12-2020,735,0,0,4,2118,429,0,0
11/16/2020,553,0,0,6,2127,429,0,0
10/15/2020,745,0,0,12,2131,429,0,0
09-06-2020,113,0,50,8,2126,429,50,0
11-05-2020,714,0,0,7,2125,429,0,0
07-09-2020,553,0,0,4,2118,960,0,0
08-08-2020,745,0,0,4,2116,500,0,0
09/19/2020,553,0,0,6,2127,429,0,0
10/13/2020,440,0,0,1,2128,962,0,0
08-12-2020,413,0,0,9,2120,963,0,0
10/15/2020,554,0,0,9,2130,449,0,0
08/14/2020,600,0,0,12,2131,419,0,0
10/21/2020,522,0,0,9,2115,255,0,0
07/16/2020,743,0,0,1,2128,429,0,0
11/25/2020,553,0,0,1,2128,429,0,0
08/27/2020,553,0,0,11,2134,963,0,0
08/19/2020,553,0,0,12,2131,936,0,0
09/23/2020,735,0,0,4,2215,549,0,0
08/21/2020,554,0,0,12,2136,459,0,0
12-06-2020,553,0,0,3,2110,174,0,0
10-07-2020,444,0,0,9,2131,962,0,0
12-05-2020,553,0,0,7,2121,962,0,0
12-05-2020,500,0,0,4,2199,519,0,0
08-04-2020,444,0,0,11,2134,962,0,0
08/28/2020,745,0,0,3,2129,519,0,0
10/13/2020,554,0,0,1,2128,400,0,0
10/15/2020,735,0,0,3,2114,429,0,0
12/31/2020,500,0,0,11,2134,900,0,0
12/29/2020,743,0,0,9,2119,429,0,0
07/18/2020,113,0,0,7,2122,429,0,0
09/20/2020,700,0,0,4,2115,460,0,0
10-08-2020,551,0,0,8,2126,429,0,0
08/24/2020,412,0,0,7,2121,962,0,0
10-03-2020,113,0,0,3,2108,400,0,0
12-05-2020,714,0,0,4,2116,400,0,0
09/23/2020,714,0,0,6,2210,449,0,0
10/14/2020,743,0,0,4,2115,400,0,0
10-07-2020,900,0,0,8,2126,400,0,0
11-11-2020,553,0,0,6,2127,419,0,0
11/21/2020,113,0,0,7,2122,429,0,0
12/20/2020,113,0,250,4,2118,429,250,0
08/14/2020,700,0,0,3,2129,400,0,0
09-03-2020,733,0,0,12,2136,500,0,0
10-05-2020,743,0,0,4,2111,429,0,0
11-05-2020,142,0,0,4,2215,900,0,0
07-04-2020,113,0,0,1,2128,429,0,0
11/26/2020,745,0,0,9,2131,429,0,0
08/24/2020,714,0,0,9,2130,400,0,0
10-05-2020,553,0,0,6,2118,900,0,0
08-04-2020,730,0,0,4,2118,519,0,0
12/15/2020,731,0,0,6,2210,460,0,0
10/22/2020,742,0,0,8,2124,429,0,0
11/21/2020,553,0,0,4,2118,429,0,0
11-04-2020,714,0,0,4,2115,429,0,0
09-11-2020,746,0,0,8,2122,429,0,0
07-09-2020,553,0,0,7,2119,963,0,0
08/30/2020,600,0,0,7,2122,962,0,0
10/15/2020,745,0,0,9,2115,331,0,0
09/29/2020,736,0,0,11,2135,429,0,0
11/21/2020,746,0,0,12,2131,400,0,0
12/21/2020,553,0,0,3,2114,400,0,0
09-09-2020,424,0,0,7,2122,429,0,0
12-04-2020,600,0,0,4,2118,900,0,0
10/20/2020,745,0,0,3,2110,599,0,0
09-04-2020,714,0,0,9,2119,429,0,0
12/29/2020,735,0,0,9,2130,173,0,0
08/30/2020,735,0,0,4,2118,400,0,0
08/23/2020,113,0,0,9,2120,429,0,0
08-02-2020,554,0,0,12,2132,429,0,0
09-05-2020,131,0,0,12,2131,900,0,0
09/30/2020,745,0,0,6,2127,429,0,0
07-08-2020,553,0,0,7,2122,900,0,0
08-10-2020,113,0,0,11,2134,429,0,0
11-08-2020,745,0,0,11,2467,460,0,0
08-04-2020,652,0,0,11,2134,429,0,0
08/20/2020,733,0,0,3,2114,882,0,0
11/26/2020,553,0,0,12,2136,400,0,0
12-06-2020,553,0,0,3,2113,429,0,0
08-03-2020,553,0,0,4,2118,200,0,0
09/30/2020,553,0,0,12,2131,429,0,0
10-04-2020,400,0,0,12,2136,429,0,0
08/23/2020,641,0,0,4,2215,900,0,0
10-06-2020,551,0,0,12,2132,500,0,0
10/19/2020,553,0,0,1,2128,962,0,0
07-03-2020,733,0,0,12,2132,419,0,0
12/17/2020,712,0,0,4,2116,429,0,0
12-01-2020,743,0,0,9,2130,519,0,0
07-09-2020,735,0,0,3,2111,400,0,0
10/29/2020,553,0,0,7,2121,962,0,0
07/21/2020,743,0,0,3,2109,599,0,0
11/21/2020,641,0,0,4,2122,500,0,0
12/22/2020,552,0,0,4,2111,174,0,0
11-02-2020,500,0,0,8,2126,962,0,0
09-02-2020,553,0,0,9,2121,960,0,0
08-11-2020,553,0,0,4,2118,962,0,0
07-09-2020,554,0,0,4,2116,400,0,0
11/29/2020,600,0,0,1,2128,960,0,0
12-08-2020,745,0,0,4,2215,981,0,0
12/31/2020,553,0,0,6,2127,174,0,0
10/25/2020,162,0,0,9,2130,174,0,0
10-01-2020,600,0,0,3,2109,900,0,0
08/15/2020,553,0,0,9,2132,900,0,0
12/18/2020,743,0,0,11,2163,439,0,0
07/31/2020,553,0,0,4,2118,960,0,0
09/20/2020,553,0,0,4,2118,960,0,0
10/16/2020,736,0,0,6,2127,429,0,0
07-07-2020,743,0,0,6,2125,429,0,0
09-05-2020,553,0,0,7,2118,960,0,0
08-07-2020,714,0,0,3,2114,400,0,0
07-01-2020,733,0,0,7,2125,429,0,0
11/21/2020,743,0,0,4,2116,429,0,0
07/17/2020,553,0,0,7,2121,429,0,0
07/25/2020,553,0,0,9,2119,900,0,0
09/14/2020,651,0,0,7,2119,400,0,0
10/15/2020,744,0,0,8,2124,429,0,0
07-03-2020,712,0,0,4,2215,400,0,0
07-02-2020,553,0,0,4,2118,900,0,0
09/26/2020,733,0,0,9,2130,419,0,0
07/30/2020,745,0,0,4,2115,429,0,0
09/19/2020,451,0,0,6,2127,963,0,0
09/21/2020,412,0,0,11,2135,429,0,0
10/21/2020,554,0,0,12,2132,321,0,0
09/29/2020,554,0,0,8,2126,419,0,0
12/15/2020,600,0,0,7,2118,960,0,0
07/20/2020,735,0,0,7,2119,400,0,0
10/17/2020,735,0,0,8,2126,429,0,0
08-03-2020,142,0,0,4,2118,900,0,0
08/28/2020,553,0,0,12,2132,419,0,0
11-05-2020,745,0,0,9,2121,429,0,0
09/19/2020,113,0,10,7,2119,400,10,0
07/17/2020,553,0,0,4,2118,962,0,0
07/18/2020,511,0,0,7,2125,962,0,0
09/18/2020,652,0,0,9,2130,439,0,0
07/21/2020,744,0,0,7,2119,429,0,0
12/16/2020,113,0,0,11,2135,460,0,0
09-10-2020,413,0,0,9,2130,960,0,0
07/13/2020,733,0,0,3,2110,599,0,0
09/27/2020,745,0,0,4,2199,500,0,0
09/14/2020,714,0,0,8,2126,429,0,0
08-10-2020,424,0,0,4,2115,429,0,0
10-03-2020,735,0,0,3,2109,965,0,0
10/20/2020,551,0,0,7,2119,419,0,0
10/13/2020,714,0,0,8,2124,419,0,0
12-02-2020,713,0,0,9,2119,429,0,0
10/16/2020,733,0,0,7,2121,429,0,0
11-03-2020,735,0,0,11,2134,500,0,0
08-06-2020,113,0,0,6,2127,429,0,0
09-04-2020,553,0,0,12,2136,963,0,0
07/21/2020,743,0,0,6,2110,511,0,0
10/22/2020,522,0,0,4,2111,331,0,0
09-03-2020,740,0,0,3,2111,963,0,0
09/30/2020,553,0,0,9,2119,962,0,0
08-07-2020,552,0,0,11,2134,963,0,0
07-01-2020,113,0,0,4,2215,462,0,0
09-11-2020,440,0,0,9,2131,419,0,0
07/28/2020,745,0,0,6,2210,439,0,0
08/24/2020,732,0,0,4,2215,629,0,0
07-07-2020,554,0,0,4,2118,400,0,0
08-09-2020,554,0,0,3,2108,439,0,0
12-03-2020,552,0,0,7,2125,429,0,0
11/29/2020,735,0,0,7,2121,160,0,0
12-02-2020,600,0,0,4,2115,429,0,0
12-12-2020,735,0,0,9,2119,429,0,0
07/15/2020,113,0,0,11,2135,429,0,0
07/22/2020,553,0,0,9,2119,931,0,0
10-07-2020,800,0,0,3,2129,962,0,0
10-06-2020,412,0,0,8,2124,900,0,0
11-12-2020,733,0,0,4,2215,400,0,0
10/17/2020,651,0,0,4,2118,429,0,0
12/30/2020,424,0,0,11,2135,429,0,0
09/18/2020,500,0,0,12,2131,429,0,0
10/13/2020,740,0,0,1,2128,419,0,0
09-05-2020,553,0,0,6,2118,960,0,0
09/15/2020,600,0,0,12,2132,419,0,0
08-08-2020,500,0,0,12,2131,419,0,0
10/15/2020,553,0,0,3,2114,400,0,0
09/13/2020,740,0,0,4,2118,400,0,0
07/18/2020,140,0,0,12,2131,900,0,0
08/24/2020,552,0,0,3,2114,900,0,0
11-07-2020,113,0,0,3,2108,419,0,0
09/19/2020,743,0,0,9,2130,400,0,0
10/26/2020,745,0,0,12,2136,429,0,0
10-02-2020,553,0,0,8,2124,213,0,0
12/13/2020,711,0,0,12,2136,960,0,0
12-01-2020,511,0,0,9,2119,429,0,0
12/21/2020,553,0,0,7,2125,962,0,0
07/17/2020,743,0,0,4,2115,429,0,0
11/19/2020,500,0,0,4,2115,400,0,0
09/26/2020,600,0,0,3,2114,960,0,0
12/20/2020,600,0,0,1,2128,900,0,0
07-03-2020,735,0,0,3,2114,459,0,0
10/29/2020,553,0,0,9,2131,419,0,0
10-08-2020,715,0,0,7,2125,429,0,0
12-11-2020,731,0,0,6,2127,500,0,0
09/30/2020,500,0,0,6,2127,429,0,0
09/30/2020,553,0,0,7,2121,960,0,0
07-11-2020,745,0,0,3,2110,599,0,0
12-02-2020,743,0,0,4,2118,429,0,0
12/23/2020,552,0,0,12,2131,960,0,0
11-03-2020,113,0,0,12,2132,439,0,0
09-01-2020,711,0,0,7,2121,900,0,0
09/15/2020,553,0,0,6,2127,962,0,0
08/13/2020,142,0,0,11,2135,419,0,0
07-05-2020,743,0,0,6,2125,449,0,0
07-05-2020,553,0,0,8,2126,900,0,0
10-12-2020,553,0,0,12,2132,900,0,0
10/30/2020,553,0,0,4,2116,400,0,0
09/30/2020,900,0,0,8,2122,400,0,0
12/31/2020,715,0,0,8,2124,429,0,0
10/13/2020,511,0,0,4,2199,900,0,0
09/26/2020,551,0,0,3,2109,519,0,0
11/26/2020,553,0,0,7,2122,962,0,0
10/25/2020,745,0,0,3,2108,500,0,0
10-06-2020,553,0,0,4,2115,429,0,0
10/24/2020,531,0,0,4,2115,400,0,0
09/30/2020,552,0,0,4,2118,888,0,0
09/20/2020,745,0,0,6,2210,400,0,0
09/25/2020,744,0,0,3,2109,419,0,0
09-07-2020,553,0,0,9,2121,429,0,0
10/21/2020,711,0,0,12,2132,963,0,0
08/29/2020,740,0,0,7,2119,161,0,0
11/26/2020,441,0,0,4,2116,449,0,0
08/16/2020,142,0,0,6,2127,900,0,0
12-06-2020,553,0,0,8,2122,900,0,0
07/18/2020,743,0,0,8,2126,429,0,0
07-03-2020,554,0,0,8,2126,429,0,0
12-05-2020,745,0,0,1,2128,400,0,0
07-01-2020,735,0,0,4,2111,173,0,0
10/30/2020,553,0,0,3,2113,429,0,0
10/13/2020,745,0,0,3,2111,241,0,0
08-12-2020,400,0,0,7,2122,981,0,0
08/27/2020,736,0,0,9,2131,429,0,0
09-04-2020,715,0,0,8,2126,429,0,0
08/25/2020,743,0,0,9,2120,400,0,0
09-12-2020,743,0,0,4,2115,460,0,0
12/23/2020,400,0,0,3,2129,429,0,0
09-10-2020,745,0,0,3,2111,500,0,0
08/28/2020,715,0,0,8,2124,419,0,0
07/26/2020,730,0,0,7,2119,500,0,0
09-04-2020,511,0,0,7,2125,960,0,0
10-08-2020,553,0,0,3,2113,963,0,0
07/29/2020,553,0,0,4,2118,400,0,0
07-11-2020,741,0,0,9,2130,429,0,0
09/14/2020,553,0,0,4,2115,439,0,0
10/30/2020,745,0,0,4,2116,400,0,0
09/18/2020,745,0,0,4,2111,429,0,0
09/17/2020,553,0,0,6,2127,960,0,0
10/17/2020,733,0,0,4,2115,152,0,0
09/21/2020,500,0,0,11,2135,429,0,0
11-12-2020,735,0,0,11,2135,429,0,0
10-12-2020,714,0,0,7,2121,429,0,0
10/26/2020,745,0,0,6,2210,599,0,0
08/15/2020,745,0,0,3,2113,429,0,0
09/17/2020,740,0,0,6,2210,500,0,0
09/16/2020,745,0,0,4,2215,400,0,0
09/21/2020,745,0,0,4,2116,161,0,0
09/17/2020,735,0,0,4,2215,429,0,0
07/22/2020,551,0,0,6,2127,940,0,0
07-04-2020,424,0,0,9,2119,419,0,0
08/31/2020,743,0,0,4,2215,429,0,0
09/17/2020,143,0,0,12,2136,951,0,0
08/30/2020,700,0,0,11,2135,429,0,0
10-03-2020,113,0,0,4,2118,429,0,0
08/21/2020,745,0,0,3,2114,500,0,0
12/31/2020,113,25,25,9,2119,429,50,0
09/23/2020,621,0,0,6,2125,900,0,0
08-08-2020,400,0,0,12,2130,429,0,0
10-04-2020,745,0,0,9,2120,429,0,0
09/27/2020,424,0,0,7,2122,429,0,0
10-07-2020,743,0,0,4,2116,500,0,0
09/21/2020,715,0,0,1,2128,439,0,0
10/23/2020,553,0,0,12,2132,311,0,0
08/20/2020,714,0,0,12,2132,419,0,0
12/13/2020,600,0,0,9,2119,100,0,0
09/17/2020,113,0,0,11,2135,400,0,0
07-10-2020,746,0,0,8,2122,400,0,0
08-02-2020,745,0,0,7,2121,429,0,0
09-11-2020,745,0,0,6,2127,429,0,0
11-08-2020,711,0,0,12,2132,962,0,0
07/23/2020,746,0,0,4,2116,429,0,0
08/19/2020,733,0,0,1,2128,429,0,0
10/15/2020,511,0,0,3,2110,519,0,0
12-12-2020,553,0,0,4,2215,962,0,0
09/27/2020,413,0,0,7,2119,960,0,0
09/25/2020,745,0,0,4,2199,429,0,0
08/20/2020,440,0,0,4,2118,429,0,0
07-06-2020,553,0,0,4,2116,960,0,0
11/24/2020,550,0,0,7,2119,965,0,0
09/22/2020,554,0,0,12,2132,460,0,0
09/23/2020,552,0,0,7,2125,960,0,0
10/30/2020,113,0,0,4,2118,400,0,0
07-01-2020,715,0,0,6,2210,173,0,0
10/17/2020,700,0,0,4,2118,429,0,0
10-01-2020,651,0,0,9,2121,429,0,0
12/29/2020,743,0,0,4,2115,429,0,0
12-09-2020,553,0,0,3,2108,900,0,0
08/23/2020,743,0,0,9,2130,429,0,0
08/26/2020,400,0,0,7,2125,960,0,0
07/29/2020,700,0,0,9,2115,460,0,0
11/30/2020,444,0,0,8,2124,429,0,0
08-01-2020,735,0,0,11,2134,891,0,0
09-02-2020,600,0,0,6,2125,961,0,0
12-03-2020,745,0,0,3,2109,400,0,0
07/21/2020,522,0,0,12,2136,429,0,0
11/29/2020,113,0,0,12,2136,400,0,0
09/14/2020,745,0,0,6,2127,419,0,0
08/14/2020,600,0,0,4,2115,900,0,0
07/15/2020,553,0,0,11,2135,429,0,0
08/14/2020,715,0,0,12,2130,419,0,0
10/16/2020,743,0,0,4,2118,429,0,0
11-07-2020,553,0,0,7,2126,100,0,0
08/24/2020,714,0,0,7,2125,400,0,0
08/16/2020,711,0,0,4,2118,960,0,0
12-09-2020,553,0,0,12,2136,429,0,0
12/22/2020,736,0,0,8,2124,429,0,0
09/28/2020,600,0,0,12,2131,419,0,0
10-07-2020,553,0,0,3,2114,900,0,0
08/29/2020,740,0,0,9,2115,429,0,0
07/28/2020,711,0,0,7,2125,960,0,0
08/21/2020,600,0,0,4,2118,900,0,0
12-01-2020,600,0,0,7,2122,569,0,0
09/29/2020,700,0,0,4,2118,400,0,0
09/18/2020,735,0,0,9,2120,429,0,0
09/30/2020,745,0,0,6,2127,429,0,0
08/17/2020,553,0,0,7,2121,429,0,0
11/17/2020,714,0,0,6,2127,900,0,0
10-05-2020,600,0,0,8,2124,429,0,0
10-07-2020,553,0,0,6,2127,429,0,0
09/30/2020,553,0,0,8,2126,900,0,0
11/26/2020,714,0,0,6,2127,429,0,0
12/21/2020,113,0,0,3,2129,400,0,0
07/23/2020,735,0,0,3,2108,500,0,0
07/23/2020,553,0,0,8,2124,419,0,0
07-11-2020,554,0,0,4,2215,459,0,0
07-03-2020,745,0,0,3,2114,599,0,0
09-06-2020,743,0,0,7,2125,592,0,0
12-04-2020,551,0,0,8,2124,900,0,0
07-01-2020,553,0,0,1,2128,419,0,0
07-04-2020,714,0,0,9,2119,400,0,0
07/20/2020,553,0,0,12,2132,419,0,0
11/23/2020,740,0,0,7,2125,429,0,0
10/23/2020,511,0,0,8,2124,439,0,0
11-11-2020,743,0,0,7,2119,429,0,0
12-10-2020,500,0,0,7,2121,519,0,0
08-01-2020,600,0,0,4,2120,962,0,0
12-11-2020,672,0,0,4,2215,400,0,0
09/24/2020,553,0,0,6,2127,400,0,0
11/30/2020,743,0,0,8,2124,429,0,0
08-01-2020,553,0,0,8,2124,429,0,0
07/27/2020,743,0,0,3,2108,419,0,0
09/27/2020,711,0,0,4,2118,900,0,0
09/20/2020,651,0,0,11,2134,429,0,0
07/13/2020,511,0,0,12,2136,429,0,0
10-05-2020,745,0,0,9,2121,419,0,0
07/22/2020,553,0,0,8,2124,962,0,0
07-07-2020,745,0,0,3,2114,599,0,0
10/16/2020,553,0,0,3,2114,500,0,0
08/20/2020,553,0,0,6,2119,900,0,0
12-12-2020,700,0,0,7,2125,429,0,0
11-08-2020,500,0,0,9,2131,900,0,0
10/22/2020,151,0,0,7,2122,962,0,0
07/27/2020,442,0,0,4,2215,952,0,0
07/30/2020,741,0,0,12,2130,173,0,0
07-09-2020,553,0,0,1,2128,960,0,0
09/25/2020,745,0,0,3,2111,599,0,0
12/31/2020,600,0,0,3,2108,960,0,0
09/30/2020,444,0,0,1,2128,963,0,0
10/21/2020,553,0,0,4,2111,962,0,0
08/21/2020,554,0,0,6,2127,429,0,0
10-06-2020,600,0,0,11,2215,429,0,0
07/19/2020,553,0,0,9,2119,960,0,0
10-05-2020,743,0,0,4,2116,162,0,0
10-08-2020,735,0,0,4,2118,429,0,0
08/30/2020,551,0,0,9,2119,960,0,0
12/15/2020,553,0,0,1,2128,400,0,0
11/26/2020,714,0,0,12,2132,500,0,0
12-12-2020,554,0,0,12,2132,400,0,0
11-12-2020,600,0,0,4,2115,963,0,0
10-07-2020,553,0,0,12,2126,900,0,0
10/24/2020,651,0,0,4,2116,429,0,0
10/29/2020,113,0,200,8,2124,419,200,0
09-12-2020,744,0,0,12,2132,429,0,0
11/25/2020,735,0,0,4,2215,429,0,0
08/18/2020,714,0,0,11,2135,400,0,0
11/17/2020,553,0,0,7,2119,960,0,0
12-08-2020,743,0,0,3,2129,429,0,0
10/13/2020,715,0,0,9,2130,439,0,0
12-11-2020,553,0,0,4,2111,429,0,0
10/19/2020,731,0,0,4,2115,429,0,0
07/27/2020,700,0,0,3,2114,960,0,0
11/24/2020,735,0,0,11,2134,429,0,0
10/25/2020,551,0,0,9,2131,400,0,0
11-06-2020,553,0,0,6,2127,900,0,0
09/22/2020,553,0,0,7,2122,429,0,0
09/22/2020,113,0,0,4,2115,419,0,0
07-08-2020,711,0,0,3,2108,963,0,0
09/26/2020,641,0,0,12,2136,962,0,0
07-09-2020,553,0,0,8,2122,963,0,0
09-01-2020,712,0,0,9,2215,331,0,0
10-05-2020,553,0,0,7,2124,419,0,0
07-04-2020,440,0,0,7,2125,429,0,0
09-09-2020,511,0,0,7,2125,965,0,0
11-09-2020,600,0,0,4,2118,429,0,0
08/23/2020,731,0,0,6,2110,882,0,0
07/14/2020,554,0,0,9,2120,429,0,0
10/23/2020,522,0,0,4,2116,429,0,0
08/18/2020,113,0,0,4,2118,400,0,0
12/26/2020,113,0,0,7,2125,429,0,0
09-12-2020,744,0,0,11,2135,429,0,0
10-05-2020,553,0,0,9,2121,429,0,0
11/19/2020,554,0,0,6,2125,429,0,0
10/30/2020,743,0,0,4,2116,400,0,0
07/22/2020,712,0,0,9,2130,960,0,0
12/13/2020,622,0,0,4,2118,960,0,0
07/28/2020,600,0,0,12,2136,429,0,0
12/30/2020,652,0,0,6,2127,429,0,0
09-06-2020,652,0,0,11,2135,429,0,0
12-03-2020,600,0,0,3,2203,960,0,0
10/26/2020,745,0,0,3,2114,400,0,0
10/23/2020,735,0,0,11,2135,331,0,0
12/16/2020,745,0,0,1,2128,429,0,0
11-03-2020,541,0,0,6,2127,400,0,0
07/22/2020,740,0,0,11,2215,429,0,0
10/31/2020,733,0,0,4,2215,900,0,0
08/21/2020,641,0,0,12,2131,900,0,0
09/22/2020,745,0,0,6,2127,429,0,0
09/28/2020,735,0,0,4,2118,429,0,0
11/26/2020,511,0,0,9,2131,429,0,0
07-04-2020,553,0,0,7,2119,900,0,0
08/26/2020,553,0,0,9,2120,459,0,0
07-09-2020,553,0,0,6,2118,888,0,0
09-02-2020,113,0,0,8,2124,429,0,0
07/13/2020,715,0,0,8,2126,429,0,0
11-09-2020,554,0,0,1,2128,400,0,0
07-09-2020,553,0,0,4,2118,960,0,0
09-09-2020,736,0,0,6,2127,429,0,0
10/31/2020,611,0,0,8,2126,900,0,0
07/28/2020,743,0,0,3,2114,161,0,0
08-04-2020,553,0,0,7,2121,962,0,0
11/14/2020,553,0,0,8,2124,429,0,0
11-04-2020,413,0,0,9,2119,365,0,0
07-01-2020,745,0,0,3,2110,429,0,0
12/16/2020,714,0,0,7,2121,429,0,0
11/18/2020,900,0,0,6,2118,963,0,0
07/14/2020,113,0,0,3,2111,322,0,0
07-11-2020,413,0,0,9,2130,965,0,0
08/18/2020,553,0,0,3,2113,900,0,0
07-07-2020,553,0,0,12,2136,419,0,0
12/24/2020,651,0,0,12,2130,429,0,0
12/25/2020,413,0,0,9,2130,419,0,0
07/24/2020,600,0,0,3,2114,900,0,0
12-03-2020,735,0,0,7,2121,429,0,0
12-11-2020,733,0,0,11,2135,429,0,0
08/21/2020,551,0,0,4,2118,429,0,0
10/31/2020,735,0,0,4,2118,400,0,0
12/15/2020,553,0,0,7,2119,900,0,0
10/14/2020,552,0,0,7,2118,965,0,0
07/13/2020,651,0,0,3,2109,429,0,0
08/20/2020,745,0,0,7,2121,419,0,0
11-02-2020,553,0,0,1,2128,400,0,0
10/15/2020,735,0,0,1,2128,429,0,0
07/15/2020,553,0,0,4,2116,960,0,0
11-12-2020,553,0,0,9,2130,419,0,0
09/23/2020,714,0,0,3,2114,429,0,0
07/16/2020,736,0,0,12,2136,419,0,0
08-05-2020,552,0,0,8,2126,900,0,0
11/18/2020,745,0,0,8,2122,511,0,0
08/23/2020,744,0,0,6,2127,449,0,0
09/21/2020,554,0,0,8,2126,400,0,0
11-04-2020,743,0,0,4,2116,500,0,0
08/27/2020,715,0,0,6,2127,400,0,0
08/20/2020,400,0,0,3,2114,365,0,0
10/26/2020,553,0,0,12,2132,962,0,0
12/25/2020,113,0,0,7,2124,429,0,0
08-03-2020,553,0,0,7,2125,962,0,0
10-07-2020,553,0,0,12,2132,962,0,0
08/14/2020,744,0,0,9,2119,429,0,0
12-03-2020,600,0,0,4,2118,938,0,0
08/19/2020,746,0,0,11,2134,429,0,0
10/15/2020,743,0,0,4,2116,429,0,0
12/27/2020,118,0,0,4,2116,429,0,0
10/25/2020,600,0,0,4,2116,581,0,0
09/20/2020,511,0,0,7,2122,960,0,0
08-06-2020,743,0,0,7,2119,200,0,0
08-01-2020,641,0,0,9,2130,963,0,0
09/18/2020,553,0,0,4,2118,960,0,0
08/13/2020,600,0,0,8,2124,419,0,0
09/23/2020,711,0,0,11,2135,962,0,0
10-05-2020,746,0,0,11,2134,419,0,0
11-10-2020,552,0,0,4,2116,429,0,0
07-07-2020,900,0,0,6,2210,254,0,0
11/23/2020,553,0,0,4,2116,900,0,0
08/14/2020,600,0,0,12,2132,900,0,0
08/23/2020,553,0,0,3,2108,429,0,0
10/14/2020,714,0,0,4,2116,400,0,0
12/30/2020,500,0,0,4,2215,400,0,0
11-02-2020,740,0,0,4,2118,400,0,0
07/14/2020,113,0,0,9,2120,429,0,0
08-05-2020,600,0,0,7,2122,962,0,0
07/15/2020,412,0,0,8,2124,429,0,0
07/29/2020,142,0,0,9,2119,141,0,0
10/17/2020,113,0,0,12,2132,419,0,0
12-09-2020,743,0,0,3,2111,321,0,0
08/14/2020,553,0,0,1,2128,160,0,0
11/17/2020,714,0,0,4,2118,429,0,0
10/15/2020,735,0,0,3,2113,429,0,0
10-03-2020,510,0,0,9,2115,429,0,0
08-02-2020,745,0,0,6,2127,429,0,0
07/30/2020,444,0,0,1,2128,960,0,0
10/27/2020,743,0,0,1,2128,500,0,0
11/20/2020,745,0,0,12,2131,500,0,0
08/18/2020,735,0,0,8,2126,429,0,0
07-09-2020,553,0,0,6,2127,400,0,0
07/15/2020,600,0,0,4,2118,400,0,0
11-02-2020,553,0,0,9,2119,429,0,0
